PokerStars Hand #149644241196:  Hold'em Limit ($3/$6 USD) - 2016/02/29 19:45:11 ET
Table 'Bitias' 6-max Seat #1 is the button
Seat 1: HAOYUN88888 ($39 in chips)
Seat 4: AzureCaper ($92.50 in chips)
HAOYUN88888: posts small blind $1
AzureCaper: posts big blind $3
*** HOLE CARDS ***
HAOYUN88888: raises $3 to $6
AzureCaper: folds
Uncalled bet ($3) returned to HAOYUN88888
HAOYUN88888 collected $6 from pot
HAOYUN88888: doesn't show hand
*** SUMMARY ***
Total pot $6 | Rake $0
Seat 1: HAOYUN88888 (button) (small blind) collected ($6)
Seat 4: AzureCaper (big blind) folded before Flop


PokerStars Hand #149644237819:  Hold'em Limit ($3/$6 USD) - 2016/02/29 19:45:05 ET
Table 'Bitias' 6-max Seat #4 is the button
Seat 1: HAOYUN88888 ($38 in chips)
Seat 4: AzureCaper ($93.50 in chips)
AzureCaper: posts small blind $1
HAOYUN88888: posts big blind $3
*** HOLE CARDS ***
AzureCaper: folds
Uncalled bet ($2) returned to HAOYUN88888
HAOYUN88888 collected $2 from pot
HAOYUN88888: doesn't show hand
*** SUMMARY ***
Total pot $2 | Rake $0
Seat 1: HAOYUN88888 (big blind) collected ($2)
Seat 4: AzureCaper (button) (small blind) folded before Flop


PokerStars Hand #149644235186:  Hold'em Limit ($3/$6 USD) - 2016/02/29 19:45:01 ET
Table 'Bitias' 6-max Seat #1 is the button
Seat 1: HAOYUN88888 ($39 in chips)
Seat 4: AzureCaper ($92.50 in chips)
HAOYUN88888: posts small blind $1
AzureCaper: posts big blind $3
*** HOLE CARDS ***
HAOYUN88888: folds
Uncalled bet ($2) returned to AzureCaper
AzureCaper collected $2 from pot
AzureCaper: doesn't show hand
*** SUMMARY ***
Total pot $2 | Rake $0
Seat 1: HAOYUN88888 (button) (small blind) folded before Flop
Seat 4: AzureCaper (big blind) collected ($2)


PokerStars Hand #149644232370:  Hold'em Limit ($3/$6 USD) - 2016/02/29 19:44:57 ET
Table 'Bitias' 6-max Seat #4 is the button
Seat 1: HAOYUN88888 ($38 in chips)
Seat 4: AzureCaper ($93.50 in chips)
AzureCaper: posts small blind $1
HAOYUN88888: posts big blind $3
*** HOLE CARDS ***
AzureCaper: folds
Uncalled bet ($2) returned to HAOYUN88888
HAOYUN88888 collected $2 from pot
HAOYUN88888: doesn't show hand
*** SUMMARY ***
Total pot $2 | Rake $0
Seat 1: HAOYUN88888 (big blind) collected ($2)
Seat 4: AzureCaper (button) (small blind) folded before Flop


PokerStars Hand #149644227894:  Hold'em Limit ($3/$6 USD) - 2016/02/29 19:44:49 ET
Table 'Bitias' 6-max Seat #1 is the button
Seat 1: HAOYUN88888 ($35 in chips)
Seat 4: AzureCaper ($96.50 in chips)
HAOYUN88888: posts small blind $1
AzureCaper: posts big blind $3
*** HOLE CARDS ***
HAOYUN88888: raises $3 to $6
AzureCaper: folds
Uncalled bet ($3) returned to HAOYUN88888
HAOYUN88888 collected $6 from pot
HAOYUN88888: doesn't show hand
*** SUMMARY ***
Total pot $6 | Rake $0
Seat 1: HAOYUN88888 (button) (small blind) collected ($6)
Seat 4: AzureCaper (big blind) folded before Flop


PokerStars Hand #149644217351:  Hold'em Limit ($3/$6 USD) - 2016/02/29 19:44:32 ET
Table 'Bitias' 6-max Seat #4 is the button
Seat 1: HAOYUN88888 ($59 in chips)
Seat 4: AzureCaper ($73 in chips)
AzureCaper: posts small blind $1
HAOYUN88888: posts big blind $3
*** HOLE CARDS ***
AzureCaper: raises $3 to $6
HAOYUN88888: calls $3
*** FLOP *** [4c 4d Js]
HAOYUN88888: checks
AzureCaper: bets $3
HAOYUN88888: raises $3 to $6
AzureCaper: calls $3
*** TURN *** [4c 4d Js] [5h]
HAOYUN88888: bets $6
AzureCaper: raises $6 to $12
HAOYUN88888: calls $6
*** RIVER *** [4c 4d Js 5h] [Jd]
HAOYUN88888: checks
AzureCaper: bets $6
HAOYUN88888: folds
Uncalled bet ($6) returned to AzureCaper
AzureCaper collected $47.50 from pot
AzureCaper: doesn't show hand
*** SUMMARY ***
Total pot $48 | Rake $0.50
Board [4c 4d Js 5h Jd]
Seat 1: HAOYUN88888 (big blind) folded on the River
Seat 4: AzureCaper (button) (small blind) collected ($47.50)


PokerStars Hand #149644270742:  Hold'em Limit ($3/$6 USD) - 2016/02/29 19:46:00 ET
Table 'Bitias' 6-max Seat #4 is the button
Seat 1: HAOYUN88888 ($60 in chips)
Seat 4: AzureCaper ($130.76 in chips)
AzureCaper: posts small blind $1
HAOYUN88888: posts big blind $3
*** HOLE CARDS ***
ogK2 joins the table at seat #3
AzureCaper: raises $3 to $6
HAOYUN88888: calls $3
*** FLOP *** [Qs Ts Qh]
HAOYUN88888: checks
AzureCaper: bets $3
HAOYUN88888: raises $3 to $6
AzureCaper: calls $3
*** TURN *** [Qs Ts Qh] [3s]
HAOYUN88888: bets $6
AzureCaper: calls $6
*** RIVER *** [Qs Ts Qh 3s] [Js]
HAOYUN88888: bets $6
AzureCaper: folds
Uncalled bet ($6) returned to HAOYUN88888
HAOYUN88888 collected $35.50 from pot
HAOYUN88888: doesn't show hand
*** SUMMARY ***
Total pot $36 | Rake $0.50
Board [Qs Ts Qh 3s Js]
Seat 1: HAOYUN88888 (big blind) collected ($35.50)
Seat 4: AzureCaper (button) (small blind) folded on the River


PokerStars Hand #149644268239:  Hold'em Limit ($3/$6 USD) - 2016/02/29 19:45:56 ET
Table 'Bitias' 6-max Seat #1 is the button
Seat 1: HAOYUN88888 ($57 in chips)
Seat 4: AzureCaper ($133.76 in chips)
HAOYUN88888: posts small blind $1
AzureCaper: posts big blind $3
*** HOLE CARDS ***
HAOYUN88888: raises $3 to $6
AzureCaper: folds
Uncalled bet ($3) returned to HAOYUN88888
HAOYUN88888 collected $6 from pot
HAOYUN88888: doesn't show hand
*** SUMMARY ***
Total pot $6 | Rake $0
Seat 1: HAOYUN88888 (button) (small blind) collected ($6)
Seat 4: AzureCaper (big blind) folded before Flop


PokerStars Hand #149644256898:  Hold'em Limit ($3/$6 USD) - 2016/02/29 19:45:37 ET
Table 'Bitias' 6-max Seat #4 is the button
Seat 1: HAOYUN88888 ($99 in chips)
Seat 4: AzureCaper ($92.26 in chips)
AzureCaper: posts small blind $1
HAOYUN88888: posts big blind $3
*** HOLE CARDS ***
AzureCaper: raises $3 to $6
HAOYUN88888: raises $3 to $9
AzureCaper: calls $3
*** FLOP *** [Ac 9c 7c]
HAOYUN88888: bets $3
AzureCaper: calls $3
*** TURN *** [Ac 9c 7c] [5s]
HAOYUN88888: bets $6
AzureCaper: raises $6 to $12
HAOYUN88888: raises $6 to $18
AzureCaper: raises $6 to $24
Betting is capped
HAOYUN88888: calls $6
*** RIVER *** [Ac 9c 7c 5s] [Qh]
HAOYUN88888: checks
AzureCaper: bets $6
HAOYUN88888: calls $6
*** SHOW DOWN ***
AzureCaper: shows [Tc 6c] (a flush, Ace high)
HAOYUN88888: mucks hand
AzureCaper collected $83.50 from pot
*** SUMMARY ***
Total pot $84 | Rake $0.50
Board [Ac 9c 7c 5s Qh]
Seat 1: HAOYUN88888 (big blind) mucked
Seat 4: AzureCaper (button) (small blind) showed [Tc 6c] and won ($83.50) with a flush, Ace high


PokerStars Hand #149644253406:  Hold'em Limit ($3/$6 USD) - 2016/02/29 19:45:31 ET
Table 'Bitias' 6-max Seat #1 is the button
Seat 1: HAOYUN88888 ($36 in chips)
Seat 4: AzureCaper ($95.26 in chips)
HAOYUN88888: posts small blind $1
AzureCaper: posts big blind $3
*** HOLE CARDS ***
HAOYUN88888: raises $3 to $6
AzureCaper: folds
Uncalled bet ($3) returned to HAOYUN88888
HAOYUN88888 collected $6 from pot
HAOYUN88888: doesn't show hand
*** SUMMARY ***
Total pot $6 | Rake $0
Seat 1: HAOYUN88888 (button) (small blind) collected ($6)
Seat 4: AzureCaper (big blind) folded before Flop


PokerStars Hand #149644244436:  Hold'em Limit ($3/$6 USD) - 2016/02/29 19:45:16 ET
Table 'Bitias' 6-max Seat #4 is the button
Seat 1: HAOYUN88888 ($42 in chips)
Seat 4: AzureCaper ($89.50 in chips)
AzureCaper: posts small blind $1
HAOYUN88888: posts big blind $3
*** HOLE CARDS ***
AzureCaper: raises $3 to $6
HAOYUN88888: calls $3
*** FLOP *** [Ah 5d Ad]
HAOYUN88888: checks
AzureCaper: bets $3
HAOYUN88888: folds
Uncalled bet ($3) returned to AzureCaper
AzureCaper collected $11.76 from pot
AzureCaper: doesn't show hand
*** SUMMARY ***
Total pot $12 | Rake $0.24
Board [Ah 5d Ad]
Seat 1: HAOYUN88888 (big blind) folded on the Flop
Seat 4: AzureCaper (button) (small blind) collected ($11.76)


PokerStars Hand #149644318428:  Hold'em Limit ($3/$6 USD) - 2016/02/29 19:47:19 ET
Table 'Bitias' 6-max Seat #4 is the button
Seat 3: ogK2 ($122.28 in chips)
Seat 4: AzureCaper ($140.76 in chips)
AzureCaper: posts small blind $1
HAOYUN88888: is sitting out
ogK2: posts big blind $3
*** HOLE CARDS ***
AzureCaper: folds
Uncalled bet ($2) returned to ogK2
ogK2 collected $2 from pot
ogK2: doesn't show hand
*** SUMMARY ***
Total pot $2 | Rake $0
Seat 3: ogK2 (big blind) collected ($2)
Seat 4: AzureCaper (button) (small blind) folded before Flop


PokerStars Hand #149644321870:  Hold'em Limit ($3/$6 USD) - 2016/02/29 19:47:25 ET
Table 'Bitias' 6-max Seat #3 is the button
Seat 3: ogK2 ($123.28 in chips)
Seat 4: AzureCaper ($139.76 in chips)
ogK2: posts small blind $1
AzureCaper: posts big blind $3
*** HOLE CARDS ***
ogK2: raises $3 to $6
AzureCaper: raises $3 to $9
ogK2: calls $3
*** FLOP *** [Qs 2s 8h]
AzureCaper: bets $3
ogK2: calls $3
*** TURN *** [Qs 2s 8h] [7c]
AzureCaper: checks
ogK2: checks
*** RIVER *** [Qs 2s 8h 7c] [Ad]
AzureCaper: checks
ogK2: bets $6
AzureCaper: raises $6 to $12
ogK2: calls $6
*** SHOW DOWN ***
AzureCaper: shows [Jc As] (a pair of Aces)
ogK2: mucks hand
AzureCaper collected $47.50 from pot
*** SUMMARY ***
Total pot $48 | Rake $0.50
Board [Qs 2s 8h 7c Ad]
Seat 3: ogK2 (button) (small blind) mucked
Seat 4: AzureCaper (big blind) showed [Jc As] and won ($47.50) with a pair of Aces


PokerStars Hand #149645136126:  Hold'em Limit ($3/$6 USD) - 2016/02/29 20:11:41 ET
Table 'Bitias' 6-max Seat #4 is the button
Seat 3: ogK2 ($103.22 in chips)
Seat 4: AzureCaper ($124.29 in chips)
AzureCaper: posts small blind $1
Necromadx: is sitting out
ogK2: posts big blind $3
*** HOLE CARDS ***
AzureCaper: raises $3 to $6
ogK2: calls $3
*** FLOP *** [Qh Kd 9c]
Necromadx leaves the table
ogK2: checks
AzureCaper: bets $3
ogK2: raises $3 to $6
AzureCaper: folds
Uncalled bet ($3) returned to ogK2
ogK2 collected $17.64 from pot
ogK2: doesn't show hand
*** SUMMARY ***
Total pot $18 | Rake $0.36
Board [Qh Kd 9c]
Seat 3: ogK2 (big blind) collected ($17.64)
Seat 4: AzureCaper (button) (small blind) folded on the Flop


