PokerStars Hand #171303765617:  Hold'em Limit ($3/$6 USD) - 2017/06/03 17:39:49 ET
Table 'Deimos' 6-max Seat #6 is the button
Seat 2: Pelurile ($158.50 in chips)
Seat 6: garry67677 ($92.40 in chips)
garry67677: posts small blind $1
Pelurile: posts big blind $3
*** HOLE CARDS ***
garry67677: raises $3 to $6
Pelurile: folds
Uncalled bet ($3) returned to garry67677
garry67677 collected $6 from pot
garry67677: doesn't show hand
*** SUMMARY ***
Total pot $6 | Rake $0
Seat 2: Pelurile (big blind) folded before Flop
Seat 6: garry67677 (button) (small blind) collected ($6)


PokerStars Hand #171303792050:  Hold'em Limit ($3/$6 USD) - 2017/06/03 17:40:27 ET
Table 'Deimos' 6-max Seat #6 is the button
Seat 2: Pelurile ($146.50 in chips)
Seat 6: garry67677 ($104.04 in chips)
garry67677: posts small blind $1
Pelurile: posts big blind $3
*** HOLE CARDS ***
garry67677: calls $2
Pelurile: checks
*** FLOP *** [As 9h 7d]
C-bet-safira joins the table at seat #4
Pelurile: checks
garry67677: checks
*** TURN *** [As 9h 7d] [Jd]
Pelurile: checks
garry67677: bets $6
Pelurile: folds
Uncalled bet ($6) returned to garry67677
garry67677 collected $5.88 from pot
garry67677: doesn't show hand
*** SUMMARY ***
Total pot $6 | Rake $0.12
Board [As 9h 7d Jd]
Seat 2: Pelurile (big blind) folded on the Turn
Seat 6: garry67677 (button) (small blind) collected ($5.88)


PokerStars Hand #171303772075:  Hold'em Limit ($3/$6 USD) - 2017/06/03 17:39:58 ET
Table 'Deimos' 6-max Seat #2 is the button
Seat 2: Pelurile ($155.50 in chips)
Seat 6: garry67677 ($95.40 in chips)
Pelurile: posts small blind $1
garry67677: posts big blind $3
*** HOLE CARDS ***
Pelurile: raises $3 to $6
garry67677: raises $3 to $9
Pelurile: calls $3
*** FLOP *** [2d 7c Ad]
garry67677: bets $3
Pelurile: folds
Uncalled bet ($3) returned to garry67677
garry67677 collected $17.64 from pot
garry67677: doesn't show hand
*** SUMMARY ***
Total pot $18 | Rake $0.36
Board [2d 7c Ad]
Seat 2: Pelurile (button) (small blind) folded on the Flop
Seat 6: garry67677 (big blind) collected ($17.64)


PokerStars Hand #171306491758:  Hold'em Limit ($3/$6 USD) - 2017/06/03 18:48:04 ET
Table 'Deimos' 6-max Seat #2 is the button
Seat 1: afghan_321 ($74.49 in chips)
Seat 2: parnishka11 ($60.33 in chips)
parnishka11: posts small blind $1
LordBorzi II: is sitting out
afghan_321: posts big blind $3
*** HOLE CARDS ***
parnishka11: raises $3 to $6
afghan_321: raises $3 to $9
parnishka11: raises $3 to $12
Betting is capped
afghan_321: calls $3
*** FLOP *** [4c 4h 2h]
afghan_321: checks
parnishka11: bets $3
afghan_321: calls $3
*** TURN *** [4c 4h 2h] [Ts]
afghan_321: checks
parnishka11: checks
*** RIVER *** [4c 4h 2h Ts] [3c]
afghan_321: bets $6
parnishka11: calls $6
*** SHOW DOWN ***
afghan_321: shows [4s 4d] (four of a kind, Fours)
parnishka11: mucks hand
afghan_321 collected $41.50 from pot
*** SUMMARY ***
Total pot $42 | Rake $0.50
Board [4c 4h 2h Ts 3c]
Seat 1: afghan_321 (big blind) showed [4s 4d] and won ($41.50) with four of a kind, Fours
Seat 2: parnishka11 (button) (small blind) mucked


