PokerStars Hand #146598117324:  Hold'em Limit ($3/$6 USD) - 2016/01/06 19:28:28 ET
Table 'Dorado II' 6-max Seat #1 is the button
Seat 1: bentinck113 ($45.02 in chips)
Seat 3: baksuzzzzzz ($25.51 in chips)
bentinck113: posts small blind $1
baksuzzzzzz: posts big blind $3
*** HOLE CARDS ***
bentinck113: folds
Uncalled bet ($2) returned to baksuzzzzzz
baksuzzzzzz collected $2 from pot
baksuzzzzzz: doesn't show hand
*** SUMMARY ***
Total pot $2 | Rake $0
Seat 1: bentinck113 (button) (small blind) folded before Flop
Seat 3: baksuzzzzzz (big blind) collected ($2)


PokerStars Hand #146598096815:  Hold'em Limit ($3/$6 USD) - 2016/01/06 19:27:59 ET
Table 'Dorado II' 6-max Seat #3 is the button
Seat 1: bentinck113 ($22.76 in chips)
Seat 3: baksuzzzzzz ($48.27 in chips)
baksuzzzzzz: posts small blind $1
krytalex: is sitting out
bentinck113: posts big blind $3
*** HOLE CARDS ***
baksuzzzzzz: raises $3 to $6
bentinck113: calls $3
*** FLOP *** [7s 8h 4s]
bentinck113: checks
baksuzzzzzz: bets $3
bentinck113: raises $3 to $6
krytalex leaves the table
baksuzzzzzz: raises $3 to $9
bentinck113: raises $3 to $12
Betting is capped
baksuzzzzzz: calls $3
*** TURN *** [7s 8h 4s] [9c]
bentinck113: bets $4.76 and is all-in
baksuzzzzzz: calls $4.76
*** RIVER *** [7s 8h 4s 9c] [4d]
*** SHOW DOWN ***
bentinck113: shows [8c 9h] (two pair, Nines and Eights)
baksuzzzzzz: mucks hand
bentinck113 collected $45.02 from pot
*** SUMMARY ***
Total pot $45.52 | Rake $0.50
Board [7s 8h 4s 9c 4d]
Seat 1: bentinck113 (big blind) showed [8c 9h] and won ($45.02) with two pair, Nines and Eights
Seat 3: baksuzzzzzz (button) (small blind) mucked


PokerStars Hand #146600778935:  Hold'em Limit ($3/$6 USD) - 2016/01/06 20:38:04 ET
Table 'Dorado II' 6-max Seat #5 is the button
Seat 5: Big_Cowboy ($90.30 in chips)
Seat 6: krytalex ($113.03 in chips)
Big_Cowboy: posts small blind $1
krytalex: posts big blind $3
*** HOLE CARDS ***
Big_Cowboy: raises $3 to $6
krytalex: calls $3
*** FLOP *** [3h Jd Kd]
krytalex: checks
Big_Cowboy: bets $3
GeluksEzel leaves the table
krytalex: folds
Uncalled bet ($3) returned to Big_Cowboy
Big_Cowboy collected $11.76 from pot
*** SUMMARY ***
Total pot $12 | Rake $0.24
Board [3h Jd Kd]
Seat 5: Big_Cowboy (button) (small blind) collected ($11.76)
Seat 6: krytalex (big blind) folded on the Flop


PokerStars Hand #146600789390:  Hold'em Limit ($3/$6 USD) - 2016/01/06 20:38:23 ET
Table 'Dorado II' 6-max Seat #6 is the button
Seat 5: Big_Cowboy ($96.06 in chips)
Seat 6: krytalex ($107.03 in chips)
krytalex: posts small blind $1
Big_Cowboy: posts big blind $3
*** HOLE CARDS ***
krytalex: raises $3 to $6
Big_Cowboy: folds
Uncalled bet ($3) returned to krytalex
krytalex collected $6 from pot
*** SUMMARY ***
Total pot $6 | Rake $0
Seat 5: Big_Cowboy (big blind) folded before Flop
Seat 6: krytalex (button) (small blind) collected ($6)


PokerStars Hand #146600799655:  Hold'em Limit ($3/$6 USD) - 2016/01/06 20:38:41 ET
Table 'Dorado II' 6-max Seat #5 is the button
Seat 5: Big_Cowboy ($93.06 in chips)
Seat 6: krytalex ($110.03 in chips)
Big_Cowboy: posts small blind $1
krytalex: posts big blind $3
*** HOLE CARDS ***
Big_Cowboy: raises $3 to $6
krytalex: calls $3
*** FLOP *** [9d 3d 4c]
yayaya joins the table at seat #2
krytalex: checks
Big_Cowboy: bets $3
krytalex: raises $3 to $6
Big_Cowboy: raises $3 to $9
krytalex: calls $3
*** TURN *** [9d 3d 4c] [6d]
krytalex: checks
Big_Cowboy: bets $6
krytalex: calls $6
*** RIVER *** [9d 3d 4c 6d] [As]
krytalex: checks
Big_Cowboy: bets $6
krytalex: folds
Uncalled bet ($6) returned to Big_Cowboy
Big_Cowboy collected $41.50 from pot
*** SUMMARY ***
Total pot $42 | Rake $0.50
Board [9d 3d 4c 6d As]
Seat 5: Big_Cowboy (button) (small blind) collected ($41.50)
Seat 6: krytalex (big blind) folded on the River


PokerStars Hand #146600898646:  Hold'em Limit ($3/$6 USD) - 2016/01/06 20:41:37 ET
Table 'Dorado II' 6-max Seat #2 is the button
Seat 2: yayaya ($137.83 in chips)
Seat 6: krytalex ($72 in chips)
yayaya: posts small blind $1
Big_Cowboy: is sitting out
krytalex: posts big blind $3
*** HOLE CARDS ***
yayaya: raises $3 to $6
Big_Cowboy leaves the table
krytalex: calls $3
*** FLOP *** [3d 7h Kd]
krytalex: checks
yayaya: bets $3
krytalex: folds
Uncalled bet ($3) returned to yayaya
yayaya collected $11.76 from pot
yayaya: doesn't show hand
*** SUMMARY ***
Total pot $12 | Rake $0.24
Board [3d 7h Kd]
Seat 2: yayaya (button) (small blind) collected ($11.76)
Seat 6: krytalex (big blind) folded on the Flop


PokerStars Hand #146600912137:  Hold'em Limit ($3/$6 USD) - 2016/01/06 20:42:01 ET
Table 'Dorado II' 6-max Seat #6 is the button
Seat 2: yayaya ($143.59 in chips)
Seat 6: krytalex ($72 in chips)
krytalex: posts small blind $1
yayaya: posts big blind $3
*** HOLE CARDS ***
krytalex: raises $3 to $6
yayaya: calls $3
*** FLOP *** [Qs 3c Td]
yayaya: checks
krytalex: bets $3
yayaya: raises $3 to $6
krytalex: calls $3
*** TURN *** [Qs 3c Td] [9h]
yayaya: bets $6
krytalex: calls $6
*** RIVER *** [Qs 3c Td 9h] [Th]
yayaya: checks
krytalex: checks
*** SHOW DOWN ***
yayaya: shows [9s Kd] (two pair, Tens and Nines)
krytalex: mucks hand
yayaya collected $35.50 from pot
*** SUMMARY ***
Total pot $36 | Rake $0.50
Board [Qs 3c Td 9h Th]
Seat 2: yayaya (big blind) showed [9s Kd] and won ($35.50) with two pair, Tens and Nines
Seat 6: krytalex (button) (small blind) mucked


PokerStars Hand #146600936815:  Hold'em Limit ($3/$6 USD) - 2016/01/06 20:42:45 ET
Table 'Dorado II' 6-max Seat #2 is the button
Seat 2: yayaya ($161.09 in chips)
Seat 6: krytalex ($72 in chips)
yayaya: posts small blind $1
krytalex: posts big blind $3
*** HOLE CARDS ***
yayaya: folds
Uncalled bet ($2) returned to krytalex
krytalex collected $2 from pot
*** SUMMARY ***
Total pot $2 | Rake $0
Seat 2: yayaya (button) (small blind) folded before Flop
Seat 6: krytalex (big blind) collected ($2)


PokerStars Hand #146600939696:  Hold'em Limit ($3/$6 USD) - 2016/01/06 20:42:50 ET
Table 'Dorado II' 6-max Seat #6 is the button
Seat 2: yayaya ($160.09 in chips)
Seat 6: krytalex ($73 in chips)
krytalex: posts small blind $1
yayaya: posts big blind $3
*** HOLE CARDS ***
krytalex: folds
Uncalled bet ($2) returned to yayaya
yayaya collected $2 from pot
yayaya: doesn't show hand
*** SUMMARY ***
Total pot $2 | Rake $0
Seat 2: yayaya (big blind) collected ($2)
Seat 6: krytalex (button) (small blind) folded before Flop


PokerStars Hand #146600947471:  Hold'em Limit ($3/$6 USD) - 2016/01/06 20:43:05 ET
Table 'Dorado II' 6-max Seat #2 is the button
Seat 2: yayaya ($161.09 in chips)
Seat 6: krytalex ($72 in chips)
yayaya: posts small blind $1
krytalex: posts big blind $3
*** HOLE CARDS ***
yayaya: raises $3 to $6
krytalex: folds
Uncalled bet ($3) returned to yayaya
yayaya collected $6 from pot
yayaya: doesn't show hand
*** SUMMARY ***
Total pot $6 | Rake $0
Seat 2: yayaya (button) (small blind) collected ($6)
Seat 6: krytalex (big blind) folded before Flop


PokerStars Hand #146600952686:  Hold'em Limit ($3/$6 USD) - 2016/01/06 20:43:14 ET
Table 'Dorado II' 6-max Seat #6 is the button
Seat 2: yayaya ($164.09 in chips)
Seat 6: krytalex ($72 in chips)
krytalex: posts small blind $1
yayaya: posts big blind $3
*** HOLE CARDS ***
krytalex: raises $3 to $6
yayaya: calls $3
*** FLOP *** [Jd 5d Ts]
yayaya: checks
krytalex: bets $3
yayaya: folds
Uncalled bet ($3) returned to krytalex
krytalex collected $11.76 from pot
*** SUMMARY ***
Total pot $12 | Rake $0.24
Board [Jd 5d Ts]
Seat 2: yayaya (big blind) folded on the Flop
Seat 6: krytalex (button) (small blind) collected ($11.76)


PokerStars Hand #146600963881:  Hold'em Limit ($3/$6 USD) - 2016/01/06 20:43:34 ET
Table 'Dorado II' 6-max Seat #2 is the button
Seat 2: yayaya ($158.09 in chips)
Seat 6: krytalex ($77.76 in chips)
yayaya: posts small blind $1
krytalex: posts big blind $3
*** HOLE CARDS ***
yayaya: raises $3 to $6
krytalex: calls $3
*** FLOP *** [Ts Qs 6s]
krytalex: checks
yayaya: bets $3
krytalex: folds
Uncalled bet ($3) returned to yayaya
yayaya collected $11.76 from pot
yayaya: doesn't show hand
*** SUMMARY ***
Total pot $12 | Rake $0.24
Board [Ts Qs 6s]
Seat 2: yayaya (button) (small blind) collected ($11.76)
Seat 6: krytalex (big blind) folded on the Flop


PokerStars Hand #146600991600:  Hold'em Limit ($3/$6 USD) - 2016/01/06 20:44:24 ET
Table 'Dorado II' 6-max Seat #6 is the button
Seat 2: yayaya ($163.85 in chips)
Seat 6: krytalex ($72 in chips)
krytalex: posts small blind $1
yayaya: posts big blind $3
*** HOLE CARDS ***
krytalex: raises $3 to $6
yayaya: calls $3
*** FLOP *** [5d Td 3s]
yayaya: checks
krytalex: bets $3
yayaya: raises $3 to $6
krytalex: calls $3
*** TURN *** [5d Td 3s] [Jd]
yayaya: bets $6
krytalex: calls $6
*** RIVER *** [5d Td 3s Jd] [7d]
yayaya: bets $6
krytalex: folds
Uncalled bet ($6) returned to yayaya
yayaya collected $35.50 from pot
yayaya: doesn't show hand
*** SUMMARY ***
Total pot $36 | Rake $0.50
Board [5d Td 3s Jd 7d]
Seat 2: yayaya (big blind) collected ($35.50)
Seat 6: krytalex (button) (small blind) folded on the River


PokerStars Hand #146601017719:  Hold'em Limit ($3/$6 USD) - 2016/01/06 20:45:11 ET
Table 'Dorado II' 6-max Seat #2 is the button
Seat 2: yayaya ($181.35 in chips)
Seat 6: krytalex ($72 in chips)
yayaya: posts small blind $1
krytalex: posts big blind $3
*** HOLE CARDS ***
yayaya: raises $3 to $6
krytalex: calls $3
*** FLOP *** [Ad Js Td]
krytalex: checks
yayaya: checks
*** TURN *** [Ad Js Td] [Kd]
krytalex: checks
yayaya: checks
*** RIVER *** [Ad Js Td Kd] [Jd]
krytalex: checks
yayaya: checks
*** SHOW DOWN ***
krytalex: shows [Jh 9c] (three of a kind, Jacks)
yayaya: mucks hand
krytalex collected $11.76 from pot
*** SUMMARY ***
Total pot $12 | Rake $0.24
Board [Ad Js Td Kd Jd]
Seat 2: yayaya (button) (small blind) mucked
Seat 6: krytalex (big blind) showed [Jh 9c] and won ($11.76) with three of a kind, Jacks


PokerStars Hand #146601039006:  Hold'em Limit ($3/$6 USD) - 2016/01/06 20:45:50 ET
Table 'Dorado II' 6-max Seat #6 is the button
Seat 2: yayaya ($175.35 in chips)
Seat 6: krytalex ($77.76 in chips)
krytalex: posts small blind $1
yayaya: posts big blind $3
*** HOLE CARDS ***
ede56 joins the table at seat #5
krytalex: raises $3 to $6
yayaya: calls $3
*** FLOP *** [2h 7c 6c]
yayaya: checks
krytalex: checks
*** TURN *** [2h 7c 6c] [7d]
yayaya: checks
krytalex: checks
*** RIVER *** [2h 7c 6c 7d] [Jh]
yayaya: checks
krytalex: checks
*** SHOW DOWN ***
yayaya: shows [5c Kd] (a pair of Sevens)
krytalex: shows [Ks 5d] (a pair of Sevens)
yayaya collected $5.88 from pot
krytalex collected $5.88 from pot
*** SUMMARY ***
Total pot $12 | Rake $0.24
Board [2h 7c 6c 7d Jh]
Seat 2: yayaya (big blind) showed [5c Kd] and won ($5.88) with a pair of Sevens
Seat 6: krytalex (button) (small blind) showed [Ks 5d] and won ($5.88) with a pair of Sevens


PokerStars Hand #146601168454:  Hold'em Limit ($3/$6 USD) - 2016/01/06 20:49:34 ET
Table 'Dorado II' 6-max Seat #5 is the button
Seat 2: yayaya ($153.76 in chips)
Seat 5: ede56 ($115.38 in chips)
ede56: posts small blind $1
yayaya: posts big blind $3
*** HOLE CARDS ***
ede56: folds
Uncalled bet ($2) returned to yayaya
yayaya collected $2 from pot
yayaya: doesn't show hand
*** SUMMARY ***
Total pot $2 | Rake $0
Seat 2: yayaya (big blind) collected ($2)
Seat 5: ede56 (button) (small blind) folded before Flop


