PokerStars Hand #147634713861:  Hold'em Limit ($3/$6 USD) - 2016/01/24 23:19:48 ET
Table 'Dschubba' 6-max Seat #6 is the button
Seat 4: AzureCaper ($72 in chips)
Seat 6: igotnoshot ($120 in chips)
igotnoshot: posts small blind $1
AzureCaper: posts big blind $3
*** HOLE CARDS ***
igotnoshot: raises $3 to $6
AzureCaper: folds
Uncalled bet ($3) returned to igotnoshot
igotnoshot collected $6 from pot
*** SUMMARY ***
Total pot $6 | Rake $0
Seat 4: AzureCaper (big blind) folded before Flop
Seat 6: igotnoshot (button) (small blind) collected ($6)


PokerStars Hand #147634716813:  Hold'em Limit ($3/$6 USD) - 2016/01/24 23:19:57 ET
Table 'Dschubba' 6-max Seat #4 is the button
Seat 4: AzureCaper ($72 in chips)
Seat 6: igotnoshot ($123 in chips)
AzureCaper: posts small blind $1
igotnoshot: posts big blind $3
*** HOLE CARDS ***
AzureCaper: folds
Uncalled bet ($2) returned to igotnoshot
igotnoshot collected $2 from pot
*** SUMMARY ***
Total pot $2 | Rake $0
Seat 4: AzureCaper (button) (small blind) folded before Flop
Seat 6: igotnoshot (big blind) collected ($2)


PokerStars Hand #147634719126:  Hold'em Limit ($3/$6 USD) - 2016/01/24 23:20:05 ET
Table 'Dschubba' 6-max Seat #6 is the button
Seat 4: AzureCaper ($72 in chips)
Seat 6: igotnoshot ($124 in chips)
igotnoshot: posts small blind $1
AzureCaper: posts big blind $3
*** HOLE CARDS ***
igotnoshot: folds
Uncalled bet ($2) returned to AzureCaper
AzureCaper collected $2 from pot
AzureCaper: doesn't show hand
*** SUMMARY ***
Total pot $2 | Rake $0
Seat 4: AzureCaper (big blind) collected ($2)
Seat 6: igotnoshot (button) (small blind) folded before Flop


PokerStars Hand #147634723504:  Hold'em Limit ($3/$6 USD) - 2016/01/24 23:20:19 ET
Table 'Dschubba' 6-max Seat #6 is the button
Seat 4: AzureCaper ($76 in chips)
Seat 6: igotnoshot ($120 in chips)
igotnoshot: posts small blind $1
AzureCaper: posts big blind $3
*** HOLE CARDS ***
igotnoshot: raises $3 to $6
AzureCaper: folds
Uncalled bet ($3) returned to igotnoshot
igotnoshot collected $6 from pot
*** SUMMARY ***
Total pot $6 | Rake $0
Seat 4: AzureCaper (big blind) folded before Flop
Seat 6: igotnoshot (button) (small blind) collected ($6)


PokerStars Hand #147634720594:  Hold'em Limit ($3/$6 USD) - 2016/01/24 23:20:09 ET
Table 'Dschubba' 6-max Seat #4 is the button
Seat 4: AzureCaper ($73 in chips)
Seat 6: igotnoshot ($123 in chips)
AzureCaper: posts small blind $1
igotnoshot: posts big blind $3
*** HOLE CARDS ***
AzureCaper: raises $3 to $6
igotnoshot: folds
Uncalled bet ($3) returned to AzureCaper
AzureCaper collected $6 from pot
AzureCaper: doesn't show hand
*** SUMMARY ***
Total pot $6 | Rake $0
Seat 4: AzureCaper (button) (small blind) collected ($6)
Seat 6: igotnoshot (big blind) folded before Flop


PokerStars Hand #147634726877:  Hold'em Limit ($3/$6 USD) - 2016/01/24 23:20:30 ET
Table 'Dschubba' 6-max Seat #6 is the button
Seat 4: AzureCaper ($76 in chips)
Seat 6: igotnoshot ($120 in chips)
igotnoshot: posts small blind $1
AzureCaper: posts big blind $3
*** HOLE CARDS ***
igotnoshot: raises $3 to $6
AzureCaper: folds
Uncalled bet ($3) returned to igotnoshot
igotnoshot collected $6 from pot
*** SUMMARY ***
Total pot $6 | Rake $0
Seat 4: AzureCaper (big blind) folded before Flop
Seat 6: igotnoshot (button) (small blind) collected ($6)


PokerStars Hand #147634725034:  Hold'em Limit ($3/$6 USD) - 2016/01/24 23:20:24 ET
Table 'Dschubba' 6-max Seat #4 is the button
Seat 4: AzureCaper ($73 in chips)
Seat 6: igotnoshot ($123 in chips)
AzureCaper: posts small blind $1
igotnoshot: posts big blind $3
*** HOLE CARDS ***
AzureCaper: raises $3 to $6
GoliafUa joins the table at seat #1
igotnoshot: folds
Uncalled bet ($3) returned to AzureCaper
AzureCaper collected $6 from pot
AzureCaper: doesn't show hand
*** SUMMARY ***
Total pot $6 | Rake $0
Seat 4: AzureCaper (button) (small blind) collected ($6)
Seat 6: igotnoshot (big blind) folded before Flop


PokerStars Hand #147634728810:  Hold'em Limit ($3/$6 USD) - 2016/01/24 23:20:36 ET
Table 'Dschubba' 6-max Seat #4 is the button
Seat 4: AzureCaper ($73 in chips)
Seat 6: igotnoshot ($123 in chips)
AzureCaper: posts small blind $1
igotnoshot: posts big blind $3
*** HOLE CARDS ***
AzureCaper: raises $3 to $6
igotnoshot: folds
Uncalled bet ($3) returned to AzureCaper
AzureCaper collected $6 from pot
AzureCaper: doesn't show hand
*** SUMMARY ***
Total pot $6 | Rake $0
Seat 4: AzureCaper (button) (small blind) collected ($6)
Seat 6: igotnoshot (big blind) folded before Flop


PokerStars Hand #147634730552:  Hold'em Limit ($3/$6 USD) - 2016/01/24 23:20:42 ET
Table 'Dschubba' 6-max Seat #6 is the button
Seat 4: AzureCaper ($76 in chips)
Seat 6: igotnoshot ($120 in chips)
igotnoshot: posts small blind $1
AzureCaper: posts big blind $3
*** HOLE CARDS ***
igotnoshot: calls $2
AzureCaper: checks
*** FLOP *** [Ks 7h 3c]
AzureCaper: bets $3
igotnoshot: folds
Uncalled bet ($3) returned to AzureCaper
AzureCaper collected $5.88 from pot
AzureCaper: doesn't show hand
*** SUMMARY ***
Total pot $6 | Rake $0.12
Board [Ks 7h 3c]
Seat 4: AzureCaper (big blind) collected ($5.88)
Seat 6: igotnoshot (button) (small blind) folded on the Flop


PokerStars Hand #147634733899:  Hold'em Limit ($3/$6 USD) - 2016/01/24 23:20:53 ET
Table 'Dschubba' 6-max Seat #4 is the button
Seat 4: AzureCaper ($78.88 in chips)
Seat 6: igotnoshot ($117 in chips)
AzureCaper: posts small blind $1
igotnoshot: posts big blind $3
*** HOLE CARDS ***
AzureCaper: raises $3 to $6
igotnoshot: raises $3 to $9
AzureCaper: calls $3
*** FLOP *** [8d 9d 6s]
igotnoshot: bets $3
AzureCaper: folds
Uncalled bet ($3) returned to igotnoshot
igotnoshot collected $17.64 from pot
*** SUMMARY ***
Total pot $18 | Rake $0.36
Board [8d 9d 6s]
Seat 4: AzureCaper (button) (small blind) folded on the Flop
Seat 6: igotnoshot (big blind) collected ($17.64)


PokerStars Hand #147634737866:  Hold'em Limit ($3/$6 USD) - 2016/01/24 23:21:06 ET
Table 'Dschubba' 6-max Seat #6 is the button
Seat 4: AzureCaper ($72 in chips)
Seat 6: igotnoshot ($125.64 in chips)
igotnoshot: posts small blind $1
AzureCaper: posts big blind $3
*** HOLE CARDS ***
igotnoshot: calls $2
AzureCaper: raises $3 to $6
igotnoshot: calls $3
*** FLOP *** [Qd 9h 7c]
AzureCaper: bets $3
igotnoshot: folds
Uncalled bet ($3) returned to AzureCaper
AzureCaper collected $11.76 from pot
AzureCaper: doesn't show hand
Sleupkeugel joins the table at seat #5
*** SUMMARY ***
Total pot $12 | Rake $0.24
Board [Qd 9h 7c]
Seat 4: AzureCaper (big blind) collected ($11.76)
Seat 6: igotnoshot (button) (small blind) folded on the Flop


PokerStars Hand #147634791915:  Hold'em Limit ($3/$6 USD) - 2016/01/24 23:24:05 ET
Table 'Dschubba' 6-max Seat #4 is the button
Seat 4: AzureCaper ($105.66 in chips)
Seat 5: Sleupkeugel ($131.38 in chips)
alpha2777 will be allowed to play after the button
AzureCaper: posts small blind $1
Sleupkeugel: posts big blind $3
*** HOLE CARDS ***
igotnoshot leaves the table
AzureCaper: raises $3 to $6
GoliafUa leaves the table
Sleupkeugel: calls $3
*** FLOP *** [7s 9c Jc]
Sleupkeugel: checks
AzureCaper: bets $3
Sleupkeugel: calls $3
*** TURN *** [7s 9c Jc] [4s]
Sleupkeugel: checks
AzureCaper: checks
*** RIVER *** [7s 9c Jc 4s] [Td]
Sleupkeugel: checks
AzureCaper: checks
*** SHOW DOWN ***
Sleupkeugel: shows [6h Ad] (high card Ace)
AzureCaper: shows [Tc Ks] (a pair of Tens)
AzureCaper collected $17.64 from pot
*** SUMMARY ***
Total pot $18 | Rake $0.36
Board [7s 9c Jc 4s Td]
Seat 4: AzureCaper (button) (small blind) showed [Tc Ks] and won ($17.64) with a pair of Tens
Seat 5: Sleupkeugel (big blind) showed [6h Ad] and lost with high card Ace


PokerStars Hand #147634912820:  Hold'em Limit ($3/$6 USD) - 2016/01/24 23:30:50 ET
Table 'Dschubba' 6-max Seat #3 is the button
Seat 2: livenuncut ($101 in chips)
Seat 3: alpha2777 ($99.22 in chips)
alpha2777: posts small blind $1
wobetting: is sitting out
livenuncut: posts big blind $3
*** HOLE CARDS ***
alpha2777: folds
Uncalled bet ($2) returned to livenuncut
livenuncut collected $2 from pot
*** SUMMARY ***
Total pot $2 | Rake $0
Seat 2: livenuncut (big blind) collected ($2)
Seat 3: alpha2777 (button) (small blind) folded before Flop


