PokerStars Hand #151540523794:  Hold'em Limit ($3/$6 USD) - 2016/04/06 18:41:10 ET
Table 'Herodias' 6-max Seat #4 is the button
Seat 3: shalomrum ($33 in chips)
Seat 4: AzureCaper ($72 in chips)
AzureCaper: posts small blind $1
shalomrum: posts big blind $3
*** HOLE CARDS ***
AzureCaper: raises $3 to $6
shalomrum: calls $3
*** FLOP *** [Qd 2d 2h]
shalomrum: checks
AzureCaper: bets $3
shalomrum: raises $3 to $6
AzureCaper: folds
Uncalled bet ($3) returned to shalomrum
shalomrum collected $17.64 from pot
shalomrum: doesn't show hand
*** SUMMARY ***
Total pot $18 | Rake $0.36
Board [Qd 2d 2h]
Seat 3: shalomrum (big blind) collected ($17.64)
Seat 4: AzureCaper (button) (small blind) folded on the Flop


PokerStars Hand #151540533218:  Hold'em Limit ($3/$6 USD) - 2016/04/06 18:41:22 ET
Table 'Herodias' 6-max Seat #3 is the button
Seat 3: shalomrum ($41.64 in chips)
Seat 4: AzureCaper ($72 in chips)
shalomrum: posts small blind $1
AzureCaper: posts big blind $3
*** HOLE CARDS ***
shalomrum: folds
Uncalled bet ($2) returned to AzureCaper
AzureCaper collected $2 from pot
AzureCaper: doesn't show hand
*** SUMMARY ***
Total pot $2 | Rake $0
Seat 3: shalomrum (button) (small blind) folded before Flop
Seat 4: AzureCaper (big blind) collected ($2)


PokerStars Hand #151540536674:  Hold'em Limit ($3/$6 USD) - 2016/04/06 18:41:27 ET
Table 'Herodias' 6-max Seat #4 is the button
Seat 3: shalomrum ($40.64 in chips)
Seat 4: AzureCaper ($73 in chips)
AzureCaper: posts small blind $1
shalomrum: posts big blind $3
*** HOLE CARDS ***
AzureCaper: raises $3 to $6
shalomrum: calls $3
*** FLOP *** [8c 6h Jh]
shalomrum: checks
AzureCaper: bets $3
shalomrum: raises $3 to $6
AzureCaper: calls $3
*** TURN *** [8c 6h Jh] [3h]
shalomrum: bets $6
AzureCaper: folds
Uncalled bet ($6) returned to shalomrum
shalomrum collected $23.52 from pot
shalomrum: doesn't show hand
*** SUMMARY ***
Total pot $24 | Rake $0.48
Board [8c 6h Jh 3h]
Seat 3: shalomrum (big blind) collected ($23.52)
Seat 4: AzureCaper (button) (small blind) folded on the Turn


PokerStars Hand #151540546106:  Hold'em Limit ($3/$6 USD) - 2016/04/06 18:41:40 ET
Table 'Herodias' 6-max Seat #3 is the button
Seat 3: shalomrum ($52.16 in chips)
Seat 4: AzureCaper ($72 in chips)
shalomrum: posts small blind $1
AzureCaper: posts big blind $3
*** HOLE CARDS ***
shalomrum: raises $3 to $6
AzureCaper: calls $3
*** FLOP *** [Qs 8s Th]
AzureCaper: checks
shalomrum: bets $3
AzureCaper: calls $3
*** TURN *** [Qs 8s Th] [Jd]
AzureCaper: checks
shalomrum: bets $6
AzureCaper: folds
Uncalled bet ($6) returned to shalomrum
shalomrum collected $17.64 from pot
shalomrum: doesn't show hand
*** SUMMARY ***
Total pot $18 | Rake $0.36
Board [Qs 8s Th Jd]
Seat 3: shalomrum (button) (small blind) collected ($17.64)
Seat 4: AzureCaper (big blind) folded on the Turn


PokerStars Hand #151540563696:  Hold'em Limit ($3/$6 USD) - 2016/04/06 18:42:03 ET
Table 'Herodias' 6-max Seat #4 is the button
Seat 3: shalomrum ($53.80 in chips)
Seat 4: AzureCaper ($78.76 in chips)
AzureCaper: posts small blind $1
shalomrum: posts big blind $3
*** HOLE CARDS ***
AzureCaper: raises $3 to $6
shalomrum: folds
Uncalled bet ($3) returned to AzureCaper
AzureCaper collected $6 from pot
AzureCaper: doesn't show hand
*** SUMMARY ***
Total pot $6 | Rake $0
Seat 3: shalomrum (big blind) folded before Flop
Seat 4: AzureCaper (button) (small blind) collected ($6)


PokerStars Hand #151540568991:  Hold'em Limit ($3/$6 USD) - 2016/04/06 18:42:11 ET
Table 'Herodias' 6-max Seat #3 is the button
Seat 3: shalomrum ($50.80 in chips)
Seat 4: AzureCaper ($81.76 in chips)
shalomrum: posts small blind $1
AzureCaper: posts big blind $3
*** HOLE CARDS ***
shalomrum: raises $3 to $6
AzureCaper: folds
Uncalled bet ($3) returned to shalomrum
shalomrum collected $6 from pot
shalomrum: doesn't show hand
*** SUMMARY ***
Total pot $6 | Rake $0
Seat 3: shalomrum (button) (small blind) collected ($6)
Seat 4: AzureCaper (big blind) folded before Flop


PokerStars Hand #151540572979:  Hold'em Limit ($3/$6 USD) - 2016/04/06 18:42:16 ET
Table 'Herodias' 6-max Seat #4 is the button
Seat 3: shalomrum ($53.80 in chips)
Seat 4: AzureCaper ($78.76 in chips)
AzureCaper: posts small blind $1
shalomrum: posts big blind $3
*** HOLE CARDS ***
AzureCaper: raises $3 to $6
shalomrum: raises $3 to $9
AzureCaper: calls $3
*** FLOP *** [6h 5d 7d]
shalomrum: bets $3
AzureCaper: calls $3
*** TURN *** [6h 5d 7d] [Ts]
shalomrum: bets $6
AzureCaper: folds
Uncalled bet ($6) returned to shalomrum
shalomrum collected $23.52 from pot
shalomrum: doesn't show hand
*** SUMMARY ***
Total pot $24 | Rake $0.48
Board [6h 5d 7d Ts]
Seat 3: shalomrum (big blind) collected ($23.52)
Seat 4: AzureCaper (button) (small blind) folded on the Turn


PokerStars Hand #151540580864:  Hold'em Limit ($3/$6 USD) - 2016/04/06 18:42:27 ET
Table 'Herodias' 6-max Seat #3 is the button
Seat 3: shalomrum ($65.32 in chips)
Seat 4: AzureCaper ($72 in chips)
shalomrum: posts small blind $1
AzureCaper: posts big blind $3
*** HOLE CARDS ***
shalomrum: folds
Uncalled bet ($2) returned to AzureCaper
AzureCaper collected $2 from pot
AzureCaper: doesn't show hand
*** SUMMARY ***
Total pot $2 | Rake $0
Seat 3: shalomrum (button) (small blind) folded before Flop
Seat 4: AzureCaper (big blind) collected ($2)


PokerStars Hand #151540560318:  Hold'em Limit ($3/$6 USD) - 2016/04/06 18:41:59 ET
Table 'Herodias' 6-max Seat #3 is the button
Seat 3: shalomrum ($54.80 in chips)
Seat 4: AzureCaper ($77.76 in chips)
shalomrum: posts small blind $1
AzureCaper: posts big blind $3
*** HOLE CARDS ***
shalomrum: folds
Uncalled bet ($2) returned to AzureCaper
AzureCaper collected $2 from pot
AzureCaper: doesn't show hand
*** SUMMARY ***
Total pot $2 | Rake $0
Seat 3: shalomrum (button) (small blind) folded before Flop
Seat 4: AzureCaper (big blind) collected ($2)


PokerStars Hand #151540553983:  Hold'em Limit ($3/$6 USD) - 2016/04/06 18:41:50 ET
Table 'Herodias' 6-max Seat #4 is the button
Seat 3: shalomrum ($60.80 in chips)
Seat 4: AzureCaper ($72 in chips)
AzureCaper: posts small blind $1
shalomrum: posts big blind $3
*** HOLE CARDS ***
AzureCaper: raises $3 to $6
shalomrum: calls $3
*** FLOP *** [5c Kd 3h]
shalomrum: checks
AzureCaper: bets $3
shalomrum: folds
Uncalled bet ($3) returned to AzureCaper
AzureCaper collected $11.76 from pot
AzureCaper: doesn't show hand
*** SUMMARY ***
Total pot $12 | Rake $0.24
Board [5c Kd 3h]
Seat 3: shalomrum (big blind) folded on the Flop
Seat 4: AzureCaper (button) (small blind) collected ($11.76)


PokerStars Hand #151540613435:  Hold'em Limit ($3/$6 USD) - 2016/04/06 18:43:10 ET
Table 'Herodias' 6-max Seat #3 is the button
Seat 3: shalomrum ($43.32 in chips)
Seat 4: AzureCaper ($93.50 in chips)
shalomrum: posts small blind $1
AzureCaper: posts big blind $3
*** HOLE CARDS ***
shalomrum: raises $3 to $6
AzureCaper: calls $3
*** FLOP *** [Ah 9s As]
PayMyAudiR8 joins the table at seat #5
AzureCaper: checks
shalomrum: bets $3
AzureCaper: raises $3 to $6
shalomrum: folds
Uncalled bet ($3) returned to AzureCaper
AzureCaper collected $17.64 from pot
AzureCaper: doesn't show hand
*** SUMMARY ***
Total pot $18 | Rake $0.36
Board [Ah 9s As]
Seat 3: shalomrum (button) (small blind) folded on the Flop
Seat 4: AzureCaper (big blind) collected ($17.64)


PokerStars Hand #151541849805:  Hold'em Limit ($3/$6 USD) - 2016/04/06 19:14:39 ET
Table 'Herodias' 6-max Seat #1 is the button
Seat 1: MissEKAmouse ($158.86 in chips)
Seat 6: Coldhandnik ($14.90 in chips)
MissEKAmouse: posts small blind $1
Coldhandnik: posts big blind $3
*** HOLE CARDS ***
MissEKAmouse: folds
Uncalled bet ($2) returned to Coldhandnik
Coldhandnik collected $2 from pot
Coldhandnik: doesn't show hand
*** SUMMARY ***
Total pot $2 | Rake $0
Seat 1: MissEKAmouse (button) (small blind) folded before Flop
Seat 6: Coldhandnik (big blind) collected ($2)


PokerStars Hand #151541870863:  Hold'em Limit ($3/$6 USD) - 2016/04/06 19:15:12 ET
Table 'Herodias' 6-max Seat #1 is the button
Seat 1: MissEKAmouse ($141.96 in chips)
Seat 6: Coldhandnik ($31.30 in chips)
MissEKAmouse: posts small blind $1
Coldhandnik: posts big blind $3
*** HOLE CARDS ***
MissEKAmouse: raises $3 to $6
Coldhandnik: folds
Uncalled bet ($3) returned to MissEKAmouse
MissEKAmouse collected $6 from pot
MissEKAmouse: doesn't show hand
*** SUMMARY ***
Total pot $6 | Rake $0
Seat 1: MissEKAmouse (button) (small blind) collected ($6)
Seat 6: Coldhandnik (big blind) folded before Flop


PokerStars Hand #151541875943:  Hold'em Limit ($3/$6 USD) - 2016/04/06 19:15:20 ET
Table 'Herodias' 6-max Seat #6 is the button
Seat 1: MissEKAmouse ($144.96 in chips)
Seat 6: Coldhandnik ($28.30 in chips)
Coldhandnik: posts small blind $1
MissEKAmouse: posts big blind $3
*** HOLE CARDS ***
Coldhandnik: raises $3 to $6
MissEKAmouse: calls $3
*** FLOP *** [6c 8s 4d]
MissEKAmouse: checks
Coldhandnik: bets $3
MissEKAmouse: raises $3 to $6
Coldhandnik: raises $3 to $9
MissEKAmouse: calls $3
*** TURN *** [6c 8s 4d] [6d]
MissEKAmouse: checks
Coldhandnik: bets $6
MissEKAmouse: calls $6
*** RIVER *** [6c 8s 4d 6d] [Js]
MissEKAmouse: checks
Coldhandnik: checks
*** SHOW DOWN ***
MissEKAmouse: shows [5h 3h] (a pair of Sixes)
Coldhandnik: shows [Ac Qh] (a pair of Sixes - Ace kicker)
Coldhandnik collected $41.50 from pot
*** SUMMARY ***
Total pot $42 | Rake $0.50
Board [6c 8s 4d 6d Js]
Seat 1: MissEKAmouse (big blind) showed [5h 3h] and lost with a pair of Sixes
Seat 6: Coldhandnik (button) (small blind) showed [Ac Qh] and won ($41.50) with a pair of Sixes


PokerStars Hand #151541928968:  Hold'em Limit ($3/$6 USD) - 2016/04/06 19:16:42 ET
Table 'Herodias' 6-max Seat #1 is the button
Seat 1: MissEKAmouse ($123.96 in chips)
Seat 2: PayMyAudiR8 ($120 in chips)
MissEKAmouse: posts small blind $1
PayMyAudiR8: posts big blind $3
*** HOLE CARDS ***
MissEKAmouse: folds
Uncalled bet ($2) returned to PayMyAudiR8
PayMyAudiR8 collected $2 from pot
PayMyAudiR8: doesn't show hand
*** SUMMARY ***
Total pot $2 | Rake $0
Seat 1: MissEKAmouse (button) (small blind) folded before Flop
Seat 2: PayMyAudiR8 (big blind) collected ($2)


PokerStars Hand #151541932985:  Hold'em Limit ($3/$6 USD) - 2016/04/06 19:16:49 ET
Table 'Herodias' 6-max Seat #2 is the button
Seat 1: MissEKAmouse ($122.96 in chips)
Seat 2: PayMyAudiR8 ($121 in chips)
PayMyAudiR8: posts small blind $1
MissEKAmouse: posts big blind $3
*** HOLE CARDS ***
PayMyAudiR8: raises $3 to $6
MissEKAmouse: calls $3
*** FLOP *** [3c Tc 6s]
MissEKAmouse: checks
PayMyAudiR8: bets $3
Coldhandnik leaves the table
MissEKAmouse: calls $3
*** TURN *** [3c Tc 6s] [5d]
MissEKAmouse: checks
PayMyAudiR8: bets $6
MissEKAmouse: calls $6
*** RIVER *** [3c Tc 6s 5d] [7d]
MissEKAmouse: bets $6
PayMyAudiR8: calls $6
*** SHOW DOWN ***
MissEKAmouse: shows [Kc 4s] (a straight, Three to Seven)
PayMyAudiR8: mucks hand
MissEKAmouse collected $41.50 from pot
*** SUMMARY ***
Total pot $42 | Rake $0.50
Board [3c Tc 6s 5d 7d]
Seat 1: MissEKAmouse (big blind) showed [Kc 4s] and won ($41.50) with a straight, Three to Seven
Seat 2: PayMyAudiR8 (button) (small blind) mucked


