PokerStars Hand #168505915024:  Hold'em Limit ($3/$6 USD) - 2017/04/03 1:29:52 ET
Table 'Irmgard' 6-max Seat #1 is the button
Seat 1: LifeisagameX ($84 in chips)
Seat 4: iupeli ($132.90 in chips)
LifeisagameX: posts small blind $1
iupeli: posts big blind $3
*** HOLE CARDS ***
LifeisagameX: raises $3 to $6
iupeli: calls $3
*** FLOP *** [Kc 8s 5h]
iupeli: checks
LifeisagameX: bets $3
iupeli: calls $3
*** TURN *** [Kc 8s 5h] [3s]
iupeli: checks
LifeisagameX: checks
*** RIVER *** [Kc 8s 5h 3s] [8c]
iupeli: bets $6
LifeisagameX: calls $6
*** SHOW DOWN ***
iupeli: shows [4s Kh] (two pair, Kings and Eights)
LifeisagameX: mucks hand
iupeli collected $29.50 from pot
*** SUMMARY ***
Total pot $30 | Rake $0.50
Board [Kc 8s 5h 3s 8c]
Seat 1: LifeisagameX (button) (small blind) mucked
Seat 4: iupeli (big blind) showed [4s Kh] and won ($29.50) with two pair, Kings and Eights


PokerStars Hand #168505946982:  Hold'em Limit ($3/$6 USD) - 2017/04/03 1:32:03 ET
Table 'Irmgard' 6-max Seat #1 is the button
Seat 1: LifeisagameX ($84 in chips)
Seat 4: iupeli ($150.28 in chips)
LifeisagameX: posts small blind $1
iupeli: posts big blind $3
*** HOLE CARDS ***
LifeisagameX: raises $3 to $6
iupeli: calls $3
*** FLOP *** [7d 3d 5c]
iupeli: checks
LifeisagameX: bets $3
iupeli: calls $3
*** TURN *** [7d 3d 5c] [3h]
iupeli: checks
LifeisagameX: checks
*** RIVER *** [7d 3d 5c 3h] [Ts]
iupeli: bets $6
LifeisagameX: folds
Uncalled bet ($6) returned to iupeli
iupeli collected $17.64 from pot
iupeli: doesn't show hand
*** SUMMARY ***
Total pot $18 | Rake $0.36
Board [7d 3d 5c 3h Ts]
Seat 1: LifeisagameX (button) (small blind) folded on the River
Seat 4: iupeli (big blind) collected ($17.64)


PokerStars Hand #168505934850:  Hold'em Limit ($3/$6 USD) - 2017/04/03 1:31:14 ET
Table 'Irmgard' 6-max Seat #4 is the button
Seat 1: LifeisagameX ($84 in chips)
Seat 4: iupeli ($147.40 in chips)
iupeli: posts small blind $1
LifeisagameX: posts big blind $3
*** HOLE CARDS ***
iupeli: calls $2
LifeisagameX: checks
*** FLOP *** [6d Kc Jc]
LifeisagameX: checks
iupeli: checks
*** TURN *** [6d Kc Jc] [6s]
LifeisagameX: checks
iupeli: bets $6
LifeisagameX: folds
Uncalled bet ($6) returned to iupeli
iupeli collected $5.88 from pot
iupeli: doesn't show hand
*** SUMMARY ***
Total pot $6 | Rake $0.12
Board [6d Kc Jc 6s]
Seat 1: LifeisagameX (big blind) folded on the Turn
Seat 4: iupeli (button) (small blind) collected ($5.88)


PokerStars Hand #168505961779:  Hold'em Limit ($3/$6 USD) - 2017/04/03 1:33:05 ET
Table 'Irmgard' 6-max Seat #1 is the button
Seat 1: LifeisagameX ($89.76 in chips)
Seat 4: iupeli ($152.92 in chips)
LifeisagameX: posts small blind $1
iupeli: posts big blind $3
*** HOLE CARDS ***
LifeisagameX: raises $3 to $6
iupeli: raises $3 to $9
LifeisagameX: calls $3
*** FLOP *** [Td 7c Ad]
iupeli: bets $3
LifeisagameX: calls $3
*** TURN *** [Td 7c Ad] [8d]
iupeli: bets $6
LifeisagameX: calls $6
*** RIVER *** [Td 7c Ad 8d] [6h]
iupeli: checks
LifeisagameX: checks
*** SHOW DOWN ***
iupeli: shows [Tc Ts] (three of a kind, Tens)
LifeisagameX: mucks hand
iupeli collected $35.50 from pot
*** SUMMARY ***
Total pot $36 | Rake $0.50
Board [Td 7c Ad 8d 6h]
Seat 1: LifeisagameX (button) (small blind) mucked
Seat 4: iupeli (big blind) showed [Tc Ts] and won ($35.50) with three of a kind, Tens


PokerStars Hand #168505970443:  Hold'em Limit ($3/$6 USD) - 2017/04/03 1:33:41 ET
Table 'Irmgard' 6-max Seat #4 is the button
Seat 1: LifeisagameX ($84 in chips)
Seat 4: iupeli ($170.42 in chips)
iupeli: posts small blind $1
LifeisagameX: posts big blind $3
*** HOLE CARDS ***
iupeli: calls $2
LifeisagameX: checks
*** FLOP *** [As Th 9c]
LifeisagameX: checks
iupeli: bets $3
LifeisagameX: folds
Uncalled bet ($3) returned to iupeli
iupeli collected $5.88 from pot
iupeli: doesn't show hand
*** SUMMARY ***
Total pot $6 | Rake $0.12
Board [As Th 9c]
Seat 1: LifeisagameX (big blind) folded on the Flop
Seat 4: iupeli (button) (small blind) collected ($5.88)


PokerStars Hand #168505981195:  Hold'em Limit ($3/$6 USD) - 2017/04/03 1:34:27 ET
Table 'Irmgard' 6-max Seat #1 is the button
Seat 1: LifeisagameX ($86.76 in chips)
Seat 4: iupeli ($170.18 in chips)
LifeisagameX: posts small blind $1
iupeli: posts big blind $3
*** HOLE CARDS ***
LifeisagameX: raises $3 to $6
iupeli: folds
Uncalled bet ($3) returned to LifeisagameX
LifeisagameX collected $6 from pot
LifeisagameX: doesn't show hand
*** SUMMARY ***
Total pot $6 | Rake $0
Seat 1: LifeisagameX (button) (small blind) collected ($6)
Seat 4: iupeli (big blind) folded before Flop


PokerStars Hand #168505977429:  Hold'em Limit ($3/$6 USD) - 2017/04/03 1:34:11 ET
Table 'Irmgard' 6-max Seat #4 is the button
Seat 1: LifeisagameX ($89.76 in chips)
Seat 4: iupeli ($167.30 in chips)
iupeli: posts small blind $1
LifeisagameX: posts big blind $3
*** HOLE CARDS ***
iupeli: calls $2
LifeisagameX: checks
*** FLOP *** [2h 7c Qd]
LifeisagameX: checks
iupeli: bets $3
LifeisagameX: folds
Uncalled bet ($3) returned to iupeli
iupeli collected $5.88 from pot
iupeli: doesn't show hand
*** SUMMARY ***
Total pot $6 | Rake $0.12
Board [2h 7c Qd]
Seat 1: LifeisagameX (big blind) folded on the Flop
Seat 4: iupeli (button) (small blind) collected ($5.88)


PokerStars Hand #168505983293:  Hold'em Limit ($3/$6 USD) - 2017/04/03 1:34:36 ET
Table 'Irmgard' 6-max Seat #4 is the button
Seat 1: LifeisagameX ($89.76 in chips)
Seat 4: iupeli ($167.18 in chips)
iupeli: posts small blind $1
LifeisagameX: posts big blind $3
*** HOLE CARDS ***
iupeli: calls $2
LifeisagameX: checks
*** FLOP *** [7d 9s As]
LifeisagameX: checks
iupeli: checks
*** TURN *** [7d 9s As] [6h]
LifeisagameX: checks
iupeli: bets $6
LifeisagameX: calls $6
*** RIVER *** [7d 9s As 6h] [Td]
LifeisagameX: checks
iupeli: bets $6
LifeisagameX: folds
Uncalled bet ($6) returned to iupeli
iupeli collected $17.64 from pot
iupeli: doesn't show hand
*** SUMMARY ***
Total pot $18 | Rake $0.36
Board [7d 9s As 6h Td]
Seat 1: LifeisagameX (big blind) folded on the River
Seat 4: iupeli (button) (small blind) collected ($17.64)


PokerStars Hand #168505998116:  Hold'em Limit ($3/$6 USD) - 2017/04/03 1:35:39 ET
Table 'Irmgard' 6-max Seat #1 is the button
Seat 1: LifeisagameX ($84 in chips)
Seat 4: iupeli ($175.82 in chips)
LifeisagameX: posts small blind $1
iupeli: posts big blind $3
*** HOLE CARDS ***
LifeisagameX: raises $3 to $6
iupeli: calls $3
*** FLOP *** [6h 4d 9c]
iupeli: checks
LifeisagameX: bets $3
iupeli: folds
Uncalled bet ($3) returned to LifeisagameX
LifeisagameX collected $11.76 from pot
LifeisagameX: doesn't show hand
*** SUMMARY ***
Total pot $12 | Rake $0.24
Board [6h 4d 9c]
Seat 1: LifeisagameX (button) (small blind) collected ($11.76)
Seat 4: iupeli (big blind) folded on the Flop


PokerStars Hand #168506004505:  Hold'em Limit ($3/$6 USD) - 2017/04/03 1:36:06 ET
Table 'Irmgard' 6-max Seat #4 is the button
Seat 1: LifeisagameX ($89.76 in chips)
Seat 4: iupeli ($169.82 in chips)
iupeli: posts small blind $1
LifeisagameX: posts big blind $3
*** HOLE CARDS ***
iupeli: calls $2
LifeisagameX: checks
*** FLOP *** [As 6c Kh]
LifeisagameX: checks
iupeli: checks
*** TURN *** [As 6c Kh] [8s]
LifeisagameX: checks
iupeli: checks
*** RIVER *** [As 6c Kh 8s] [Ks]
LifeisagameX: checks
iupeli: checks
*** SHOW DOWN ***
LifeisagameX: shows [6d 3d] (two pair, Kings and Sixes)
iupeli: mucks hand
LifeisagameX collected $5.88 from pot
*** SUMMARY ***
Total pot $6 | Rake $0.12
Board [As 6c Kh 8s Ks]
Seat 1: LifeisagameX (big blind) showed [6d 3d] and won ($5.88) with two pair, Kings and Sixes
Seat 4: iupeli (button) (small blind) mucked


PokerStars Hand #168506020196:  Hold'em Limit ($3/$6 USD) - 2017/04/03 1:37:13 ET
Table 'Irmgard' 6-max Seat #4 is the button
Seat 1: LifeisagameX ($84 in chips)
Seat 4: iupeli ($184.32 in chips)
iupeli: posts small blind $1
LifeisagameX: posts big blind $3
*** HOLE CARDS ***
iupeli: calls $2
LifeisagameX: raises $3 to $6
iupeli: calls $3
*** FLOP *** [9s 3s 5h]
LifeisagameX: bets $3
iupeli: folds
Uncalled bet ($3) returned to LifeisagameX
LifeisagameX collected $11.76 from pot
LifeisagameX: doesn't show hand
*** SUMMARY ***
Total pot $12 | Rake $0.24
Board [9s 3s 5h]
Seat 1: LifeisagameX (big blind) collected ($11.76)
Seat 4: iupeli (button) (small blind) folded on the Flop


PokerStars Hand #168506012468:  Hold'em Limit ($3/$6 USD) - 2017/04/03 1:36:41 ET
Table 'Irmgard' 6-max Seat #1 is the button
Seat 1: LifeisagameX ($92.64 in chips)
Seat 4: iupeli ($166.82 in chips)
LifeisagameX: posts small blind $1
iupeli: posts big blind $3
*** HOLE CARDS ***
LifeisagameX: raises $3 to $6
iupeli: calls $3
*** FLOP *** [4d Ah Qh]
iupeli: checks
LifeisagameX: checks
*** TURN *** [4d Ah Qh] [Jd]
iupeli: checks
LifeisagameX: bets $6
iupeli: calls $6
*** RIVER *** [4d Ah Qh Jd] [Ks]
iupeli: checks
LifeisagameX: bets $6
iupeli: calls $6
*** SHOW DOWN ***
LifeisagameX: shows [7h Qd] (a pair of Queens)
iupeli: shows [2d Kd] (a pair of Kings)
iupeli collected $35.50 from pot
*** SUMMARY ***
Total pot $36 | Rake $0.50
Board [4d Ah Qh Jd Ks]
Seat 1: LifeisagameX (button) (small blind) showed [7h Qd] and lost with a pair of Queens
Seat 4: iupeli (big blind) showed [2d Kd] and won ($35.50) with a pair of Kings


PokerStars Hand #168506023760:  Hold'em Limit ($3/$6 USD) - 2017/04/03 1:37:28 ET
Table 'Irmgard' 6-max Seat #1 is the button
Seat 1: LifeisagameX ($89.76 in chips)
Seat 4: iupeli ($178.32 in chips)
LifeisagameX: posts small blind $1
iupeli: posts big blind $3
*** HOLE CARDS ***
LifeisagameX: raises $3 to $6
iupeli: calls $3
*** FLOP *** [3c 9d Jh]
iupeli: checks
LifeisagameX: checks
*** TURN *** [3c 9d Jh] [2s]
iupeli: bets $6
LifeisagameX: folds
Uncalled bet ($6) returned to iupeli
iupeli collected $11.76 from pot
iupeli: doesn't show hand
*** SUMMARY ***
Total pot $12 | Rake $0.24
Board [3c 9d Jh 2s]
Seat 1: LifeisagameX (button) (small blind) folded on the Turn
Seat 4: iupeli (big blind) collected ($11.76)


PokerStars Hand #168506028082:  Hold'em Limit ($3/$6 USD) - 2017/04/03 1:37:46 ET
Table 'Irmgard' 6-max Seat #4 is the button
Seat 1: LifeisagameX ($84 in chips)
Seat 4: iupeli ($184.08 in chips)
iupeli: posts small blind $1
LifeisagameX: posts big blind $3
*** HOLE CARDS ***
iupeli: calls $2
LifeisagameX: raises $3 to $6
iupeli: calls $3
*** FLOP *** [7d Th 9s]
LifeisagameX: bets $3
iupeli: calls $3
*** TURN *** [7d Th 9s] [2s]
LifeisagameX: checks
iupeli: bets $6
LifeisagameX: calls $6
*** RIVER *** [7d Th 9s 2s] [Td]
LifeisagameX: checks
iupeli: bets $6
ChippYulya joins the table at seat #3
LifeisagameX: folds
Uncalled bet ($6) returned to iupeli
iupeli collected $29.50 from pot
iupeli: doesn't show hand
*** SUMMARY ***
Total pot $30 | Rake $0.50
Board [7d Th 9s 2s Td]
Seat 1: LifeisagameX (big blind) folded on the River
Seat 4: iupeli (button) (small blind) collected ($29.50)


PokerStars Hand #168506052389:  Hold'em Limit ($3/$6 USD) - 2017/04/03 1:39:28 ET
Table 'Irmgard' 6-max Seat #4 is the button
Seat 3: ChippYulya ($127.19 in chips)
Seat 4: iupeli ($191.22 in chips)
iupeli: posts small blind $1
ChippYulya: posts big blind $3
*** HOLE CARDS ***
iupeli: raises $3 to $6
ChippYulya: raises $3 to $9
iupeli: calls $3
*** FLOP *** [Qd 6h 3d]
ChippYulya: bets $3
iupeli: calls $3
*** TURN *** [Qd 6h 3d] [8c]
ChippYulya: bets $6
iupeli: calls $6
*** RIVER *** [Qd 6h 3d 8c] [9h]
ChippYulya: bets $6
iupeli: calls $6
*** SHOW DOWN ***
ChippYulya: shows [Ah 9c] (a pair of Nines)
iupeli: mucks hand
ChippYulya collected $47.50 from pot
*** SUMMARY ***
Total pot $48 | Rake $0.50
Board [Qd 6h 3d 8c 9h]
Seat 3: ChippYulya (big blind) showed [Ah 9c] and won ($47.50) with a pair of Nines
Seat 4: iupeli (button) (small blind) mucked


PokerStars Hand #168506047359:  Hold'em Limit ($3/$6 USD) - 2017/04/03 1:39:07 ET
Table 'Irmgard' 6-max Seat #3 is the button
Seat 3: ChippYulya ($136.19 in chips)
Seat 4: iupeli ($182.58 in chips)
ChippYulya: posts small blind $1
iupeli: posts big blind $3
*** HOLE CARDS ***
ChippYulya: raises $3 to $6
iupeli: calls $3
*** FLOP *** [6c 5s 3s]
iupeli: checks
ChippYulya: bets $3
iupeli: calls $3
*** TURN *** [6c 5s 3s] [4d]
iupeli: checks
ChippYulya: checks
*** RIVER *** [6c 5s 3s 4d] [8s]
iupeli: bets $6
ChippYulya: folds
Uncalled bet ($6) returned to iupeli
iupeli collected $17.64 from pot
iupeli: doesn't show hand
*** SUMMARY ***
Total pot $18 | Rake $0.36
Board [6c 5s 3s 4d 8s]
Seat 3: ChippYulya (button) (small blind) folded on the River
Seat 4: iupeli (big blind) collected ($17.64)


PokerStars Hand #168506046011:  Hold'em Limit ($3/$6 USD) - 2017/04/03 1:39:01 ET
Table 'Irmgard' 6-max Seat #4 is the button
Seat 3: ChippYulya ($135.19 in chips)
Seat 4: iupeli ($183.58 in chips)
iupeli: posts small blind $1
ChippYulya: posts big blind $3
*** HOLE CARDS ***
iupeli: folds
Uncalled bet ($2) returned to ChippYulya
ChippYulya collected $2 from pot
ChippYulya: doesn't show hand
*** SUMMARY ***
Total pot $2 | Rake $0
Seat 3: ChippYulya (big blind) collected ($2)
Seat 4: iupeli (button) (small blind) folded before Flop


PokerStars Hand #168506043454:  Hold'em Limit ($3/$6 USD) - 2017/04/03 1:38:50 ET
Table 'Irmgard' 6-max Seat #3 is the button
Seat 3: ChippYulya ($129.43 in chips)
Seat 4: iupeli ($189.58 in chips)
ChippYulya: posts small blind $1
iupeli: posts big blind $3
*** HOLE CARDS ***
ChippYulya: raises $3 to $6
iupeli: calls $3
*** FLOP *** [Ks 5d Kd]
iupeli: checks
ChippYulya: bets $3
iupeli: folds
Uncalled bet ($3) returned to ChippYulya
ChippYulya collected $11.76 from pot
ChippYulya: doesn't show hand
*** SUMMARY ***
Total pot $12 | Rake $0.24
Board [Ks 5d Kd]
Seat 3: ChippYulya (button) (small blind) collected ($11.76)
Seat 4: iupeli (big blind) folded on the Flop


PokerStars Hand #168506057361:  Hold'em Limit ($3/$6 USD) - 2017/04/03 1:39:49 ET
Table 'Irmgard' 6-max Seat #3 is the button
Seat 3: ChippYulya ($150.69 in chips)
Seat 4: iupeli ($167.22 in chips)
ChippYulya: posts small blind $1
iupeli: posts big blind $3
*** HOLE CARDS ***
ChippYulya: raises $3 to $6
iupeli: calls $3
*** FLOP *** [Qd Qc 6c]
Pti4ka_Tucan joins the table at seat #5
iupeli: checks
ChippYulya: bets $3
iupeli: calls $3
*** TURN *** [Qd Qc 6c] [4s]
iupeli: checks
ChippYulya: bets $6
iupeli: folds
Uncalled bet ($6) returned to ChippYulya
ChippYulya collected $17.64 from pot
ChippYulya: doesn't show hand
*** SUMMARY ***
Total pot $18 | Rake $0.36
Board [Qd Qc 6c 4s]
Seat 3: ChippYulya (button) (small blind) collected ($17.64)
Seat 4: iupeli (big blind) folded on the Turn


