PokerStars Hand #157949366255:  Hold'em Limit ($3/$6 USD) - 2016/08/30 17:02:46 ET
Table 'Nanking' 6-max Seat #3 is the button
Seat 3: anebodil ($90 in chips)
Seat 4: Hannibal2211 ($72 in chips)
anebodil: posts small blind $1
Hannibal2211: posts big blind $3
*** HOLE CARDS ***
anebodil: folds
Uncalled bet ($2) returned to Hannibal2211
Hannibal2211 collected $2 from pot
*** SUMMARY ***
Total pot $2 | Rake $0
Seat 3: anebodil (button) (small blind) folded before Flop
Seat 4: Hannibal2211 (big blind) collected ($2)


PokerStars Hand #157949404539:  Hold'em Limit ($3/$6 USD) - 2016/08/30 17:03:32 ET
Table 'Nanking' 6-max Seat #3 is the button
Seat 3: anebodil ($82 in chips)
Seat 4: Hannibal2211 ($80 in chips)
anebodil: posts small blind $1
Hannibal2211: posts big blind $3
*** HOLE CARDS ***
anebodil: raises $3 to $6
Hannibal2211: folds
Uncalled bet ($3) returned to anebodil
anebodil collected $6 from pot
*** SUMMARY ***
Total pot $6 | Rake $0
Seat 3: anebodil (button) (small blind) collected ($6)
Seat 4: Hannibal2211 (big blind) folded before Flop


PokerStars Hand #157949399449:  Hold'em Limit ($3/$6 USD) - 2016/08/30 17:03:26 ET
Table 'Nanking' 6-max Seat #4 is the button
Seat 3: anebodil ($85 in chips)
Seat 4: Hannibal2211 ($77 in chips)
Hannibal2211: posts small blind $1
anebodil: posts big blind $3
*** HOLE CARDS ***
Hannibal2211: raises $3 to $6
anebodil: folds
Uncalled bet ($3) returned to Hannibal2211
Hannibal2211 collected $6 from pot
*** SUMMARY ***
Total pot $6 | Rake $0
Seat 3: anebodil (big blind) folded before Flop
Seat 4: Hannibal2211 (button) (small blind) collected ($6)


PokerStars Hand #157949390246:  Hold'em Limit ($3/$6 USD) - 2016/08/30 17:03:15 ET
Table 'Nanking' 6-max Seat #3 is the button
Seat 3: anebodil ($86 in chips)
Seat 4: Hannibal2211 ($76 in chips)
anebodil: posts small blind $1
Hannibal2211: posts big blind $3
*** HOLE CARDS ***
anebodil: folds
Uncalled bet ($2) returned to Hannibal2211
Hannibal2211 collected $2 from pot
*** SUMMARY ***
Total pot $2 | Rake $0
Seat 3: anebodil (button) (small blind) folded before Flop
Seat 4: Hannibal2211 (big blind) collected ($2)


PokerStars Hand #157949383627:  Hold'em Limit ($3/$6 USD) - 2016/08/30 17:03:07 ET
Table 'Nanking' 6-max Seat #4 is the button
Seat 3: anebodil ($89 in chips)
Seat 4: Hannibal2211 ($73 in chips)
Hannibal2211: posts small blind $1
anebodil: posts big blind $3
*** HOLE CARDS ***
Hannibal2211: raises $3 to $6
anebodil: folds
Uncalled bet ($3) returned to Hannibal2211
Hannibal2211 collected $6 from pot
*** SUMMARY ***
Total pot $6 | Rake $0
Seat 3: anebodil (big blind) folded before Flop
Seat 4: Hannibal2211 (button) (small blind) collected ($6)


PokerStars Hand #157949377203:  Hold'em Limit ($3/$6 USD) - 2016/08/30 17:02:59 ET
Table 'Nanking' 6-max Seat #3 is the button
Seat 3: anebodil ($86 in chips)
Seat 4: Hannibal2211 ($76 in chips)
anebodil: posts small blind $1
Hannibal2211: posts big blind $3
*** HOLE CARDS ***
anebodil: raises $3 to $6
Hannibal2211: folds
Uncalled bet ($3) returned to anebodil
anebodil collected $6 from pot
*** SUMMARY ***
Total pot $6 | Rake $0
Seat 3: anebodil (button) (small blind) collected ($6)
Seat 4: Hannibal2211 (big blind) folded before Flop


PokerStars Hand #157949370741:  Hold'em Limit ($3/$6 USD) - 2016/08/30 17:02:51 ET
Table 'Nanking' 6-max Seat #4 is the button
Seat 3: anebodil ($89 in chips)
Seat 4: Hannibal2211 ($73 in chips)
Hannibal2211: posts small blind $1
anebodil: posts big blind $3
*** HOLE CARDS ***
Hannibal2211: raises $3 to $6
anebodil: folds
Uncalled bet ($3) returned to Hannibal2211
Hannibal2211 collected $6 from pot
*** SUMMARY ***
Total pot $6 | Rake $0
Seat 3: anebodil (big blind) folded before Flop
Seat 4: Hannibal2211 (button) (small blind) collected ($6)


PokerStars Hand #157949446968:  Hold'em Limit ($3/$6 USD) - 2016/08/30 17:04:23 ET
Table 'Nanking' 6-max Seat #4 is the button
Seat 3: anebodil ($105.26 in chips)
Seat 4: Hannibal2211 ($72 in chips)
Hannibal2211: posts small blind $1
anebodil: posts big blind $3
*** HOLE CARDS ***
Hannibal2211: folds
Uncalled bet ($2) returned to anebodil
anebodil collected $2 from pot
*** SUMMARY ***
Total pot $2 | Rake $0
Seat 3: anebodil (big blind) collected ($2)
Seat 4: Hannibal2211 (button) (small blind) folded before Flop


PokerStars Hand #157949428042:  Hold'em Limit ($3/$6 USD) - 2016/08/30 17:04:01 ET
Table 'Nanking' 6-max Seat #3 is the button
Seat 3: anebodil ($99.50 in chips)
Seat 4: Hannibal2211 ($72 in chips)
anebodil: posts small blind $1
Hannibal2211: posts big blind $3
*** HOLE CARDS ***
anebodil: raises $3 to $6
Hannibal2211: calls $3
*** FLOP *** [8c Kd Th]
Hannibal2211: checks
anebodil: checks
*** TURN *** [8c Kd Th] [5h]
Hannibal2211: checks
anebodil: checks
*** RIVER *** [8c Kd Th 5h] [2h]
Hannibal2211: checks
anebodil: checks
*** SHOW DOWN ***
Hannibal2211: shows [3s 7s] (high card King)
anebodil: shows [Qs Ah] (high card Ace)
anebodil collected $11.76 from pot
*** SUMMARY ***
Total pot $12 | Rake $0.24
Board [8c Kd Th 5h 2h]
Seat 3: anebodil (button) (small blind) showed [Qs Ah] and won ($11.76) with high card Ace
Seat 4: Hannibal2211 (big blind) showed [3s 7s] and lost with high card King


PokerStars Hand #157949410662:  Hold'em Limit ($3/$6 USD) - 2016/08/30 17:03:39 ET
Table 'Nanking' 6-max Seat #4 is the button
Seat 3: anebodil ($85 in chips)
Seat 4: Hannibal2211 ($77 in chips)
Hannibal2211: posts small blind $1
anebodil: posts big blind $3
*** HOLE CARDS ***
Hannibal2211: raises $3 to $6
anebodil: calls $3
*** FLOP *** [Ad Jh 2s]
anebodil: bets $3
Hannibal2211: calls $3
*** TURN *** [Ad Jh 2s] [5c]
anebodil: bets $6
Hannibal2211: calls $6
*** RIVER *** [Ad Jh 2s 5c] [8s]
anebodil: bets $6
Hannibal2211: folds
Uncalled bet ($6) returned to anebodil
anebodil collected $29.50 from pot
*** SUMMARY ***
Total pot $30 | Rake $0.50
Board [Ad Jh 2s 5c 8s]
Seat 3: anebodil (big blind) collected ($29.50)
Seat 4: Hannibal2211 (button) (small blind) folded on the River


PokerStars Hand #157949451113:  Hold'em Limit ($3/$6 USD) - 2016/08/30 17:04:28 ET
Table 'Nanking' 6-max Seat #3 is the button
Seat 3: anebodil ($106.26 in chips)
Seat 4: Hannibal2211 ($72 in chips)
anebodil: posts small blind $1
Hannibal2211: posts big blind $3
*** HOLE CARDS ***
anebodil: raises $3 to $6
Hannibal2211: calls $3
*** FLOP *** [7d Jc 2h]
Hannibal2211: checks
anebodil: bets $3
Hannibal2211: raises $3 to $6
anebodil: calls $3
*** TURN *** [7d Jc 2h] [9s]
Hannibal2211: bets $6
anebodil: calls $6
*** RIVER *** [7d Jc 2h 9s] [Kh]
Hannibal2211: checks
anebodil: bets $6
Hannibal2211: calls $6
*** SHOW DOWN ***
anebodil: shows [Jh Qh] (a pair of Jacks)
Hannibal2211: mucks hand
anebodil collected $47.50 from pot
*** SUMMARY ***
Total pot $48 | Rake $0.50
Board [7d Jc 2h 9s Kh]
Seat 3: anebodil (button) (small blind) showed [Jh Qh] and won ($47.50) with a pair of Jacks
Seat 4: Hannibal2211 (big blind) mucked


PokerStars Hand #157949485096:  Hold'em Limit ($3/$6 USD) - 2016/08/30 17:05:09 ET
Table 'Nanking' 6-max Seat #3 is the button
Seat 3: anebodil ($123.76 in chips)
Seat 4: Hannibal2211 ($77.76 in chips)
anebodil: posts small blind $1
Hannibal2211: posts big blind $3
*** HOLE CARDS ***
anebodil: raises $3 to $6
Hannibal2211: raises $3 to $9
anebodil: calls $3
*** FLOP *** [8h Ts 8c]
Hannibal2211: bets $3
anebodil: calls $3
*** TURN *** [8h Ts 8c] [Jh]
Hannibal2211: checks
anebodil: checks
*** RIVER *** [8h Ts 8c Jh] [7d]
Hannibal2211: checks
anebodil: checks
*** SHOW DOWN ***
Hannibal2211: shows [Ac Kh] (a pair of Eights)
anebodil: mucks hand
Hannibal2211 collected $23.52 from pot
*** SUMMARY ***
Total pot $24 | Rake $0.48
Board [8h Ts 8c Jh 7d]
Seat 3: anebodil (button) (small blind) mucked
Seat 4: Hannibal2211 (big blind) showed [Ac Kh] and won ($23.52) with a pair of Eights


PokerStars Hand #157949473914:  Hold'em Limit ($3/$6 USD) - 2016/08/30 17:04:56 ET
Table 'Nanking' 6-max Seat #4 is the button
Seat 3: anebodil ($129.76 in chips)
Seat 4: Hannibal2211 ($72 in chips)
Hannibal2211: posts small blind $1
anebodil: posts big blind $3
*** HOLE CARDS ***
Hannibal2211: raises $3 to $6
anebodil: calls $3
*** FLOP *** [Td 2s 3h]
anebodil: checks
Hannibal2211: bets $3
anebodil: folds
Uncalled bet ($3) returned to Hannibal2211
Hannibal2211 collected $11.76 from pot
*** SUMMARY ***
Total pot $12 | Rake $0.24
Board [Td 2s 3h]
Seat 3: anebodil (big blind) folded on the Flop
Seat 4: Hannibal2211 (button) (small blind) collected ($11.76)


PokerStars Hand #157949526362:  Hold'em Limit ($3/$6 USD) - 2016/08/30 17:05:58 ET
Table 'Nanking' 6-max Seat #3 is the button
Seat 3: anebodil ($120.40 in chips)
Seat 4: Hannibal2211 ($80.28 in chips)
anebodil: posts small blind $1
Hannibal2211: posts big blind $3
*** HOLE CARDS ***
anebodil: raises $3 to $6
Hannibal2211: calls $3
*** FLOP *** [7d Ks 9c]
Hannibal2211: checks
anebodil: bets $3
Hannibal2211: calls $3
*** TURN *** [7d Ks 9c] [Kc]
Hannibal2211: checks
anebodil: bets $6
Hannibal2211: folds
Uncalled bet ($6) returned to anebodil
anebodil collected $17.64 from pot
*** SUMMARY ***
Total pot $18 | Rake $0.36
Board [7d Ks 9c Kc]
Seat 3: anebodil (button) (small blind) collected ($17.64)
Seat 4: Hannibal2211 (big blind) folded on the Turn


PokerStars Hand #157949505230:  Hold'em Limit ($3/$6 USD) - 2016/08/30 17:05:33 ET
Table 'Nanking' 6-max Seat #4 is the button
Seat 3: anebodil ($111.76 in chips)
Seat 4: Hannibal2211 ($89.28 in chips)
Hannibal2211: posts small blind $1
anebodil: posts big blind $3
*** HOLE CARDS ***
Hannibal2211: raises $3 to $6
anebodil: calls $3
*** FLOP *** [5s Qs 6d]
anebodil: checks
Hannibal2211: bets $3
anebodil: calls $3
*** TURN *** [5s Qs 6d] [9d]
anebodil: checks
Hannibal2211: checks
*** RIVER *** [5s Qs 6d 9d] [8h]
anebodil: bets $6
Hannibal2211: folds
Uncalled bet ($6) returned to anebodil
anebodil collected $17.64 from pot
*** SUMMARY ***
Total pot $18 | Rake $0.36
Board [5s Qs 6d 9d 8h]
Seat 3: anebodil (big blind) collected ($17.64)
Seat 4: Hannibal2211 (button) (small blind) folded on the River


PokerStars Hand #157949543758:  Hold'em Limit ($3/$6 USD) - 2016/08/30 17:06:19 ET
Table 'Nanking' 6-max Seat #4 is the button
Seat 3: anebodil ($129.04 in chips)
Seat 4: Hannibal2211 ($72 in chips)
Hannibal2211: posts small blind $1
anebodil: posts big blind $3
*** HOLE CARDS ***
Hannibal2211: raises $3 to $6
anebodil: folds
Uncalled bet ($3) returned to Hannibal2211
Hannibal2211 collected $6 from pot
*** SUMMARY ***
Total pot $6 | Rake $0
Seat 3: anebodil (big blind) folded before Flop
Seat 4: Hannibal2211 (button) (small blind) collected ($6)


PokerStars Hand #157949549986:  Hold'em Limit ($3/$6 USD) - 2016/08/30 17:06:27 ET
Table 'Nanking' 6-max Seat #3 is the button
Seat 3: anebodil ($126.04 in chips)
Seat 4: Hannibal2211 ($75 in chips)
anebodil: posts small blind $1
Hannibal2211: posts big blind $3
*** HOLE CARDS ***
anebodil: raises $3 to $6
Hannibal2211: calls $3
*** FLOP *** [Qh 4c 4d]
Hannibal2211: checks
anebodil: checks
*** TURN *** [Qh 4c 4d] [9d]
Hannibal2211: bets $6
anebodil: calls $6
*** RIVER *** [Qh 4c 4d 9d] [2s]
Hannibal2211: bets $6
anebodil: calls $6
*** SHOW DOWN ***
Hannibal2211: shows [2h Qd] (two pair, Queens and Fours)
anebodil: mucks hand
Hannibal2211 collected $35.50 from pot
*** SUMMARY ***
Total pot $36 | Rake $0.50
Board [Qh 4c 4d 9d 2s]
Seat 3: anebodil (button) (small blind) mucked
Seat 4: Hannibal2211 (big blind) showed [2h Qd] and won ($35.50) with two pair, Queens and Fours


PokerStars Hand #157949589849:  Hold'em Limit ($3/$6 USD) - 2016/08/30 17:07:16 ET
Table 'Nanking' 6-max Seat #3 is the button
Seat 3: anebodil ($81.04 in chips)
Seat 4: Hannibal2211 ($119 in chips)
anebodil: posts small blind $1
Hannibal2211: posts big blind $3
*** HOLE CARDS ***
anebodil: folds
Uncalled bet ($2) returned to Hannibal2211
Hannibal2211 collected $2 from pot
*** SUMMARY ***
Total pot $2 | Rake $0
Seat 3: anebodil (button) (small blind) folded before Flop
Seat 4: Hannibal2211 (big blind) collected ($2)


PokerStars Hand #157949569384:  Hold'em Limit ($3/$6 USD) - 2016/08/30 17:06:50 ET
Table 'Nanking' 6-max Seat #4 is the button
Seat 3: anebodil ($108.04 in chips)
Seat 4: Hannibal2211 ($92.50 in chips)
Hannibal2211: posts small blind $1
anebodil: posts big blind $3
*** HOLE CARDS ***
Hannibal2211: raises $3 to $6
anebodil: raises $3 to $9
Hannibal2211: raises $3 to $12
Betting is capped
anebodil: calls $3
*** FLOP *** [Jd Tc 3h]
anebodil: bets $3
Hannibal2211: calls $3
*** TURN *** [Jd Tc 3h] [2d]
anebodil: bets $6
Hannibal2211: calls $6
*** RIVER *** [Jd Tc 3h 2d] [2c]
anebodil: bets $6
Hannibal2211: calls $6
*** SHOW DOWN ***
anebodil: shows [Kd As] (a pair of Deuces)
Hannibal2211: shows [7h 7s] (two pair, Sevens and Deuces)
Hannibal2211 collected $53.50 from pot
*** SUMMARY ***
Total pot $54 | Rake $0.50
Board [Jd Tc 3h 2d 2c]
Seat 3: anebodil (big blind) showed [Kd As] and lost with a pair of Deuces
Seat 4: Hannibal2211 (button) (small blind) showed [7h 7s] and won ($53.50) with two pair, Sevens and Deuces


PokerStars Hand #157949614073:  Hold'em Limit ($3/$6 USD) - 2016/08/30 17:07:45 ET
Table 'Nanking' 6-max Seat #3 is the button
Seat 3: anebodil ($53.04 in chips)
Seat 4: Hannibal2211 ($146.50 in chips)
anebodil: posts small blind $1
Hannibal2211: posts big blind $3
*** HOLE CARDS ***
anebodil: folds
Uncalled bet ($2) returned to Hannibal2211
Hannibal2211 collected $2 from pot
*** SUMMARY ***
Total pot $2 | Rake $0
Seat 3: anebodil (button) (small blind) folded before Flop
Seat 4: Hannibal2211 (big blind) collected ($2)


PokerStars Hand #157949641251:  Hold'em Limit ($3/$6 USD) - 2016/08/30 17:08:19 ET
Table 'Nanking' 6-max Seat #3 is the button
Seat 3: anebodil ($57.80 in chips)
Seat 4: Hannibal2211 ($141.50 in chips)
anebodil: posts small blind $1
Hannibal2211: posts big blind $3
*** HOLE CARDS ***
anebodil: calls $2
Hannibal2211: raises $3 to $6
anebodil: calls $3
*** FLOP *** [4c 7c 7d]
Hannibal2211: bets $3
anebodil: calls $3
*** TURN *** [4c 7c 7d] [9d]
Hannibal2211: bets $6
anebodil: calls $6
*** RIVER *** [4c 7c 7d 9d] [Jd]
Hannibal2211: checks
anebodil: checks
*** SHOW DOWN ***
Hannibal2211: shows [Ah Ts] (a pair of Sevens)
anebodil: shows [3h 4d] (two pair, Sevens and Fours)
anebodil collected $29.50 from pot
*** SUMMARY ***
Total pot $30 | Rake $0.50
Board [4c 7c 7d 9d Jd]
Seat 3: anebodil (button) (small blind) showed [3h 4d] and won ($29.50) with two pair, Sevens and Fours
Seat 4: Hannibal2211 (big blind) showed [Ah Ts] and lost with a pair of Sevens


PokerStars Hand #157949636154:  Hold'em Limit ($3/$6 USD) - 2016/08/30 17:08:12 ET
Table 'Nanking' 6-max Seat #4 is the button
Seat 3: anebodil ($60.80 in chips)
Seat 4: Hannibal2211 ($138.50 in chips)
Hannibal2211: posts small blind $1
anebodil: posts big blind $3
*** HOLE CARDS ***
Hannibal2211: raises $3 to $6
anebodil: folds
Uncalled bet ($3) returned to Hannibal2211
Hannibal2211 collected $6 from pot
*** SUMMARY ***
Total pot $6 | Rake $0
Seat 3: anebodil (big blind) folded before Flop
Seat 4: Hannibal2211 (button) (small blind) collected ($6)


PokerStars Hand #157949628941:  Hold'em Limit ($3/$6 USD) - 2016/08/30 17:08:03 ET
Table 'Nanking' 6-max Seat #3 is the button
Seat 3: anebodil ($57.80 in chips)
Seat 4: Hannibal2211 ($141.50 in chips)
anebodil: posts small blind $1
Hannibal2211: posts big blind $3
*** HOLE CARDS ***
anebodil: raises $3 to $6
Hannibal2211: folds
Uncalled bet ($3) returned to anebodil
anebodil collected $6 from pot
*** SUMMARY ***
Total pot $6 | Rake $0
Seat 3: anebodil (button) (small blind) collected ($6)
Seat 4: Hannibal2211 (big blind) folded before Flop


PokerStars Hand #157949618068:  Hold'em Limit ($3/$6 USD) - 2016/08/30 17:07:50 ET
Table 'Nanking' 6-max Seat #4 is the button
Seat 3: anebodil ($52.04 in chips)
Seat 4: Hannibal2211 ($147.50 in chips)
Hannibal2211: posts small blind $1
anebodil: posts big blind $3
*** HOLE CARDS ***
Hannibal2211: raises $3 to $6
anebodil: calls $3
*** FLOP *** [4c 6s Js]
anebodil: checks
Hannibal2211: checks
*** TURN *** [4c 6s Js] [Kh]
anebodil: bets $6
Hannibal2211: folds
Uncalled bet ($6) returned to anebodil
anebodil collected $11.76 from pot
*** SUMMARY ***
Total pot $12 | Rake $0.24
Board [4c 6s Js Kh]
Seat 3: anebodil (big blind) collected ($11.76)
Seat 4: Hannibal2211 (button) (small blind) folded on the Turn


PokerStars Hand #157949673261:  Hold'em Limit ($3/$6 USD) - 2016/08/30 17:08:58 ET
Table 'Nanking' 6-max Seat #3 is the button
Seat 3: anebodil ($51.30 in chips)
Seat 4: Hannibal2211 ($147 in chips)
anebodil: posts small blind $1
Hannibal2211: posts big blind $3
*** HOLE CARDS ***
anebodil: raises $3 to $6
Hannibal2211: calls $3
*** FLOP *** [6s 3h 8h]
Hannibal2211: checks
anebodil: checks
*** TURN *** [6s 3h 8h] [4h]
Hannibal2211: bets $6
anebodil: calls $6
*** RIVER *** [6s 3h 8h 4h] [3c]
Hannibal2211: bets $6
anebodil: folds
Uncalled bet ($6) returned to Hannibal2211
Hannibal2211 collected $23.52 from pot
*** SUMMARY ***
Total pot $24 | Rake $0.48
Board [6s 3h 8h 4h 3c]
Seat 3: anebodil (button) (small blind) folded on the River
Seat 4: Hannibal2211 (big blind) collected ($23.52)


PokerStars Hand #157949655847:  Hold'em Limit ($3/$6 USD) - 2016/08/30 17:08:37 ET
Table 'Nanking' 6-max Seat #4 is the button
Seat 3: anebodil ($72.30 in chips)
Seat 4: Hannibal2211 ($126.50 in chips)
Hannibal2211: posts small blind $1
anebodil: posts big blind $3
*** HOLE CARDS ***
Hannibal2211: raises $3 to $6
anebodil: calls $3
*** FLOP *** [Qd 8s 5h]
anebodil: checks
Hannibal2211: bets $3
anebodil: calls $3
*** TURN *** [Qd 8s 5h] [4s]
anebodil: checks
Hannibal2211: bets $6
anebodil: calls $6
*** RIVER *** [Qd 8s 5h 4s] [9c]
anebodil: checks
Hannibal2211: bets $6
anebodil: calls $6
*** SHOW DOWN ***
Hannibal2211: shows [Qh 6d] (a pair of Queens)
anebodil: mucks hand
Hannibal2211 collected $41.50 from pot
*** SUMMARY ***
Total pot $42 | Rake $0.50
Board [Qd 8s 5h 4s 9c]
Seat 3: anebodil (big blind) mucked
Seat 4: Hannibal2211 (button) (small blind) showed [Qh 6d] and won ($41.50) with a pair of Queens


PokerStars Hand #157949724881:  Hold'em Limit ($3/$6 USD) - 2016/08/30 17:10:03 ET
Table 'Nanking' 6-max Seat #3 is the button
Seat 3: anebodil ($45.06 in chips)
Seat 4: Hannibal2211 ($152.52 in chips)
anebodil: posts small blind $1
Hannibal2211: posts big blind $3
*** HOLE CARDS ***
anebodil: raises $3 to $6
Hannibal2211: calls $3
*** FLOP *** [3s 8c Th]
Hannibal2211: checks
anebodil: bets $3
Hannibal2211: folds
Uncalled bet ($3) returned to anebodil
anebodil collected $11.76 from pot
*** SUMMARY ***
Total pot $12 | Rake $0.24
Board [3s 8c Th]
Seat 3: anebodil (button) (small blind) collected ($11.76)
Seat 4: Hannibal2211 (big blind) folded on the Flop


PokerStars Hand #157949736671:  Hold'em Limit ($3/$6 USD) - 2016/08/30 17:10:17 ET
Table 'Nanking' 6-max Seat #4 is the button
Seat 3: anebodil ($50.82 in chips)
Seat 4: Hannibal2211 ($146.52 in chips)
Hannibal2211: posts small blind $1
anebodil: posts big blind $3
*** HOLE CARDS ***
Hannibal2211: raises $3 to $6
anebodil: calls $3
*** FLOP *** [7c 6h 7s]
anebodil: checks
Hannibal2211: checks
*** TURN *** [7c 6h 7s] [5c]
anebodil: bets $6
Hannibal2211: calls $6
*** RIVER *** [7c 6h 7s 5c] [Td]
anebodil: bets $6
Hannibal2211: folds
Uncalled bet ($6) returned to anebodil
anebodil collected $23.52 from pot
*** SUMMARY ***
Total pot $24 | Rake $0.48
Board [7c 6h 7s 5c Td]
Seat 3: anebodil (big blind) collected ($23.52)
Seat 4: Hannibal2211 (button) (small blind) folded on the River


PokerStars Hand #157949751300:  Hold'em Limit ($3/$6 USD) - 2016/08/30 17:10:36 ET
Table 'Nanking' 6-max Seat #3 is the button
Seat 3: anebodil ($62.34 in chips)
Seat 4: Hannibal2211 ($134.52 in chips)
anebodil: posts small blind $1
Hannibal2211: posts big blind $3
*** HOLE CARDS ***
anebodil: calls $2
Hannibal2211: checks
*** FLOP *** [3s 2h 3c]
Chessnok joins the table at seat #6
Hannibal2211: bets $3
anebodil: calls $3
*** TURN *** [3s 2h 3c] [Jd]
Hannibal2211: checks
anebodil: checks
*** RIVER *** [3s 2h 3c Jd] [Js]
Hannibal2211: bets $6
anebodil: folds
Uncalled bet ($6) returned to Hannibal2211
Hannibal2211 collected $11.76 from pot
*** SUMMARY ***
Total pot $12 | Rake $0.24
Board [3s 2h 3c Jd Js]
Seat 3: anebodil (button) (small blind) folded on the River
Seat 4: Hannibal2211 (big blind) collected ($11.76)


PokerStars Hand #157949822695:  Hold'em Limit ($3/$6 USD) - 2016/08/30 17:12:04 ET
Table 'Nanking' 6-max Seat #4 is the button
Seat 3: anebodil ($8.34 in chips)
Seat 4: Hannibal2211 ($142.10 in chips)
Hannibal2211: posts small blind $1
Chessnok: is sitting out
anebodil: posts big blind $3
*** HOLE CARDS ***
Hannibal2211: raises $3 to $6
anebodil: calls $3
*** FLOP *** [Qc Qh 9h]
anebodil: checks
Hannibal2211: bets $3
anebodil: calls $2.34 and is all-in
Uncalled bet ($0.66) returned to Hannibal2211
*** TURN *** [Qc Qh 9h] [8h]
*** RIVER *** [Qc Qh 9h 8h] [5s]
*** SHOW DOWN ***
anebodil: shows [4d Kc] (a pair of Queens)
Hannibal2211: shows [Jh As] (a pair of Queens - Ace kicker)
Hannibal2211 collected $16.35 from pot
*** SUMMARY ***
Total pot $16.68 | Rake $0.33
Board [Qc Qh 9h 8h 5s]
Seat 3: anebodil (big blind) showed [4d Kc] and lost with a pair of Queens
Seat 4: Hannibal2211 (button) (small blind) showed [Jh As] and won ($16.35) with a pair of Queens


