PokerStars Hand #147724917188:  Hold'em Limit ($3/$6 USD) - 2016/01/26 15:09:48 ET
Table 'Ndola' 6-max Seat #3 is the button
Seat 3: ajmaster333 ($60.75 in chips)
Seat 4: AzureCaper ($75 in chips)
ajmaster333: posts small blind $1
AzureCaper: posts big blind $3
*** HOLE CARDS ***
ajmaster333: raises $3 to $6
AzureCaper: calls $3
*** FLOP *** [6h 3h 6d]
AzureCaper: checks
ajmaster333: bets $3
AzureCaper: calls $3
*** TURN *** [6h 3h 6d] [Kd]
AzureCaper: bets $6
ajmaster333: calls $6
*** RIVER *** [6h 3h 6d Kd] [Ks]
AzureCaper: bets $6
ajmaster333: calls $6
*** SHOW DOWN ***
AzureCaper: shows [Kc Qd] (a full house, Kings full of Sixes)
ajmaster333: mucks hand
AzureCaper collected $41.50 from pot
*** SUMMARY ***
Total pot $42 | Rake $0.50
Board [6h 3h 6d Kd Ks]
Seat 3: ajmaster333 (button) (small blind) mucked
Seat 4: AzureCaper (big blind) showed [Kc Qd] and won ($41.50) with a full house, Kings full of Sixes


PokerStars Hand #147728291231:  Hold'em Limit ($3/$6 USD) - 2016/01/26 16:00:24 ET
Table 'Ndola' 6-max Seat #3 is the button
Seat 2: Arketypen ($42.06 in chips)
Seat 3: SashaYuvelir ($72 in chips)
SashaYuvelir: posts small blind $1
Arketypen: posts big blind $3
*** HOLE CARDS ***
SashaYuvelir: raises $3 to $6
Arketypen: calls $3
*** FLOP *** [9c 5d Qd]
Arketypen: checks
SashaYuvelir: bets $3
Arketypen: raises $3 to $6
SashaYuvelir: calls $3
*** TURN *** [9c 5d Qd] [Jh]
Arketypen: bets $6
SashaYuvelir: calls $6
*** RIVER *** [9c 5d Qd Jh] [4c]
Arketypen: bets $6
Big_M joins the table at seat #5
SashaYuvelir: calls $6
*** SHOW DOWN ***
Arketypen: shows [5h Jc] (two pair, Jacks and Fives)
SashaYuvelir: mucks hand
Arketypen collected $47.50 from pot
*** SUMMARY ***
Total pot $48 | Rake $0.50
Board [9c 5d Qd Jh 4c]
Seat 2: Arketypen (big blind) showed [5h Jc] and won ($47.50) with two pair, Jacks and Fives
Seat 3: SashaYuvelir (button) (small blind) mucked


PokerStars Hand #147728306209:  Hold'em Limit ($3/$6 USD) - 2016/01/26 16:00:40 ET
Table 'Ndola' 6-max Seat #2 is the button
Seat 2: Arketypen ($65.56 in chips)
Seat 3: SashaYuvelir ($72 in chips)
Arketypen: posts small blind $1
SashaYuvelir: posts big blind $3
*** HOLE CARDS ***
Arketypen: raises $3 to $6
SashaYuvelir: calls $3
*** FLOP *** [4h 8h 4d]
SashaYuvelir: checks
Arketypen: bets $3
SashaYuvelir: folds
Uncalled bet ($3) returned to Arketypen
Arketypen collected $11.76 from pot
Arketypen: doesn't show hand
*** SUMMARY ***
Total pot $12 | Rake $0.24
Board [4h 8h 4d]
Seat 2: Arketypen (button) (small blind) collected ($11.76)
Seat 3: SashaYuvelir (big blind) folded on the Flop


PokerStars Hand #147728477565:  Hold'em Limit ($3/$6 USD) - 2016/01/26 16:03:19 ET
Table 'Ndola' 6-max Seat #5 is the button
Seat 3: SashaYuvelir ($77.43 in chips)
Seat 5: Big_M ($91.47 in chips)
Big_M: posts small blind $1
SashaYuvelir: posts big blind $3
*** HOLE CARDS ***
Big_M: raises $3 to $6
SashaYuvelir: raises $3 to $9
Big_M: calls $3
*** FLOP *** [Qd Tc Th]
SashaYuvelir: bets $3
Big_M: calls $3
*** TURN *** [Qd Tc Th] [5c]
SashaYuvelir: bets $6
Big_M: folds
Uncalled bet ($6) returned to SashaYuvelir
SashaYuvelir collected $23.52 from pot
SashaYuvelir: doesn't show hand
*** SUMMARY ***
Total pot $24 | Rake $0.48
Board [Qd Tc Th 5c]
Seat 3: SashaYuvelir (big blind) collected ($23.52)
Seat 5: Big_M (button) (small blind) folded on the Turn


PokerStars Hand #147728528814:  Hold'em Limit ($3/$6 USD) - 2016/01/26 16:04:04 ET
Table 'Ndola' 6-max Seat #5 is the button
Seat 2: Arketypen ($76.89 in chips)
Seat 5: Big_M ($80.47 in chips)
Big_M: posts small blind $1
Arketypen: posts big blind $3
*** HOLE CARDS ***
Big_M: raises $3 to $6
Arketypen: folds
Uncalled bet ($3) returned to Big_M
Big_M collected $6 from pot
*** SUMMARY ***
Total pot $6 | Rake $0
Seat 2: Arketypen (big blind) folded before Flop
Seat 5: Big_M (button) (small blind) collected ($6)


PokerStars Hand #147728522302:  Hold'em Limit ($3/$6 USD) - 2016/01/26 16:03:59 ET
Table 'Ndola' 6-max Seat #2 is the button
Seat 2: Arketypen ($77.89 in chips)
Seat 5: Big_M ($79.47 in chips)
Arketypen: posts small blind $1
SashaYuvelir: is sitting out
Big_M: posts big blind $3
*** HOLE CARDS ***
Arketypen: folds
Uncalled bet ($2) returned to Big_M
Big_M collected $2 from pot
*** SUMMARY ***
Total pot $2 | Rake $0
Seat 2: Arketypen (button) (small blind) folded before Flop
Seat 5: Big_M (big blind) collected ($2)


