PokerStars Hand #171736699900:  Hold'em Limit ($3/$6 USD) - 2017/06/13 16:28:45 ET
Table 'Rafita II' 6-max Seat #3 is the button
Seat 3: krytalex ($121.73 in chips)
Seat 4: NewRocker ($120 in chips)
krytalex: posts small blind $1
NewRocker: posts big blind $3
*** HOLE CARDS ***
krytalex: raises $3 to $6
NewRocker: folds
Uncalled bet ($3) returned to krytalex
krytalex collected $6 from pot
*** SUMMARY ***
Total pot $6 | Rake $0
Seat 3: krytalex (button) (small blind) collected ($6)
Seat 4: NewRocker (big blind) folded before Flop


PokerStars Hand #171736722025:  Hold'em Limit ($3/$6 USD) - 2017/06/13 16:29:11 ET
Table 'Rafita II' 6-max Seat #4 is the button
Seat 3: krytalex ($124.73 in chips)
Seat 4: NewRocker ($117 in chips)
NewRocker: posts small blind $1
krytalex: posts big blind $3
*** HOLE CARDS ***
NewRocker: folds
Uncalled bet ($2) returned to krytalex
krytalex collected $2 from pot
*** SUMMARY ***
Total pot $2 | Rake $0
Seat 3: krytalex (big blind) collected ($2)
Seat 4: NewRocker (button) (small blind) folded before Flop


PokerStars Hand #171736733359:  Hold'em Limit ($3/$6 USD) - 2017/06/13 16:29:25 ET
Table 'Rafita II' 6-max Seat #3 is the button
Seat 3: krytalex ($125.73 in chips)
Seat 4: NewRocker ($116 in chips)
krytalex: posts small blind $1
NewRocker: posts big blind $3
*** HOLE CARDS ***
krytalex: raises $3 to $6
NewRocker: raises $3 to $9
krytalex: calls $3
*** FLOP *** [Ac 9d 5s]
NewRocker: bets $3
krytalex: folds
Uncalled bet ($3) returned to NewRocker
NewRocker collected $17.64 from pot
NewRocker: doesn't show hand
*** SUMMARY ***
Total pot $18 | Rake $0.36
Board [Ac 9d 5s]
Seat 3: krytalex (button) (small blind) folded on the Flop
Seat 4: NewRocker (big blind) collected ($17.64)


PokerStars Hand #171736754103:  Hold'em Limit ($3/$6 USD) - 2017/06/13 16:29:50 ET
Table 'Rafita II' 6-max Seat #4 is the button
Seat 3: krytalex ($116.73 in chips)
Seat 4: NewRocker ($124.64 in chips)
NewRocker: posts small blind $1
krytalex: posts big blind $3
*** HOLE CARDS ***
NewRocker: folds
Uncalled bet ($2) returned to krytalex
krytalex collected $2 from pot
*** SUMMARY ***
Total pot $2 | Rake $0
Seat 3: krytalex (big blind) collected ($2)
Seat 4: NewRocker (button) (small blind) folded before Flop


PokerStars Hand #171736767675:  Hold'em Limit ($3/$6 USD) - 2017/06/13 16:30:07 ET
Table 'Rafita II' 6-max Seat #3 is the button
Seat 3: krytalex ($117.73 in chips)
Seat 4: NewRocker ($123.64 in chips)
krytalex: posts small blind $1
NewRocker: posts big blind $3
*** HOLE CARDS ***
krytalex: raises $3 to $6
NewRocker: calls $3
*** FLOP *** [7d Jh 9s]
NewRocker: checks
krytalex: bets $3
NewRocker: folds
Uncalled bet ($3) returned to krytalex
krytalex collected $11.76 from pot
*** SUMMARY ***
Total pot $12 | Rake $0.24
Board [7d Jh 9s]
Seat 3: krytalex (button) (small blind) collected ($11.76)
Seat 4: NewRocker (big blind) folded on the Flop


PokerStars Hand #171736786423:  Hold'em Limit ($3/$6 USD) - 2017/06/13 16:30:29 ET
Table 'Rafita II' 6-max Seat #4 is the button
Seat 3: krytalex ($123.49 in chips)
Seat 4: NewRocker ($117.64 in chips)
NewRocker: posts small blind $1
krytalex: posts big blind $3
*** HOLE CARDS ***
NewRocker: raises $3 to $6
krytalex: folds
Uncalled bet ($3) returned to NewRocker
NewRocker collected $6 from pot
NewRocker: doesn't show hand
*** SUMMARY ***
Total pot $6 | Rake $0
Seat 3: krytalex (big blind) folded before Flop
Seat 4: NewRocker (button) (small blind) collected ($6)


PokerStars Hand #171736804513:  Hold'em Limit ($3/$6 USD) - 2017/06/13 16:30:51 ET
Table 'Rafita II' 6-max Seat #4 is the button
Seat 3: krytalex ($114.49 in chips)
Seat 4: NewRocker ($126.40 in chips)
NewRocker: posts small blind $1
krytalex: posts big blind $3
*** HOLE CARDS ***
NewRocker: folds
Uncalled bet ($2) returned to krytalex
krytalex collected $2 from pot
*** SUMMARY ***
Total pot $2 | Rake $0
Seat 3: krytalex (big blind) collected ($2)
Seat 4: NewRocker (button) (small blind) folded before Flop


PokerStars Hand #171736794415:  Hold'em Limit ($3/$6 USD) - 2017/06/13 16:30:39 ET
Table 'Rafita II' 6-max Seat #3 is the button
Seat 3: krytalex ($120.49 in chips)
Seat 4: NewRocker ($120.64 in chips)
krytalex: posts small blind $1
NewRocker: posts big blind $3
*** HOLE CARDS ***
krytalex: raises $3 to $6
NewRocker: calls $3
*** FLOP *** [Jc 3d Tc]
NewRocker: bets $3
krytalex: folds
Uncalled bet ($3) returned to NewRocker
NewRocker collected $11.76 from pot
NewRocker: doesn't show hand
*** SUMMARY ***
Total pot $12 | Rake $0.24
Board [Jc 3d Tc]
Seat 3: krytalex (button) (small blind) folded on the Flop
Seat 4: NewRocker (big blind) collected ($11.76)


PokerStars Hand #171736809377:  Hold'em Limit ($3/$6 USD) - 2017/06/13 16:30:57 ET
Table 'Rafita II' 6-max Seat #3 is the button
Seat 3: krytalex ($115.49 in chips)
Seat 4: NewRocker ($125.40 in chips)
krytalex: posts small blind $1
NewRocker: posts big blind $3
*** HOLE CARDS ***
krytalex: raises $3 to $6
NewRocker: calls $3
*** FLOP *** [5d Qc 2c]
NewRocker: checks
krytalex: bets $3
NewRocker: calls $3
*** TURN *** [5d Qc 2c] [5c]
NewRocker: checks
krytalex: checks
*** RIVER *** [5d Qc 2c 5c] [3s]
NewRocker: bets $6
krytalex: folds
Uncalled bet ($6) returned to NewRocker
NewRocker collected $17.64 from pot
NewRocker: doesn't show hand
*** SUMMARY ***
Total pot $18 | Rake $0.36
Board [5d Qc 2c 5c 3s]
Seat 3: krytalex (button) (small blind) folded on the River
Seat 4: NewRocker (big blind) collected ($17.64)


PokerStars Hand #171736852062:  Hold'em Limit ($3/$6 USD) - 2017/06/13 16:31:48 ET
Table 'Rafita II' 6-max Seat #4 is the button
Seat 3: krytalex ($106.49 in chips)
Seat 4: NewRocker ($134.04 in chips)
NewRocker: posts small blind $1
krytalex: posts big blind $3
*** HOLE CARDS ***
NewRocker: raises $3 to $6
krytalex: calls $3
*** FLOP *** [7h Kc 8d]
krytalex: checks
NewRocker: bets $3
krytalex: folds
Uncalled bet ($3) returned to NewRocker
NewRocker collected $11.76 from pot
NewRocker: doesn't show hand
*** SUMMARY ***
Total pot $12 | Rake $0.24
Board [7h Kc 8d]
Seat 3: krytalex (big blind) folded on the Flop
Seat 4: NewRocker (button) (small blind) collected ($11.76)


PokerStars Hand #171736881386:  Hold'em Limit ($3/$6 USD) - 2017/06/13 16:32:23 ET
Table 'Rafita II' 6-max Seat #3 is the button
Seat 3: krytalex ($100.49 in chips)
Seat 4: NewRocker ($139.80 in chips)
krytalex: posts small blind $1
NewRocker: posts big blind $3
*** HOLE CARDS ***
krytalex: raises $3 to $6
NewRocker: calls $3
*** FLOP *** [9d 6d Ad]
NewRocker: checks
krytalex: bets $3
NewRocker: folds
Uncalled bet ($3) returned to krytalex
krytalex collected $11.76 from pot
*** SUMMARY ***
Total pot $12 | Rake $0.24
Board [9d 6d Ad]
Seat 3: krytalex (button) (small blind) collected ($11.76)
Seat 4: NewRocker (big blind) folded on the Flop


PokerStars Hand #171737229666:  Hold'em Limit ($3/$6 USD) - 2017/06/13 16:39:23 ET
Table 'Rafita II' 6-max Seat #4 is the button
Seat 3: krytalex ($106.25 in chips)
Seat 4: igorkabmw ($30 in chips)
igorkabmw: posts small blind $1
krytalex: posts big blind $3
*** HOLE CARDS ***
igorkabmw: calls $2
krytalex: checks
*** FLOP *** [7h 5d Kc]
krytalex: checks
igorkabmw: checks
*** TURN *** [7h 5d Kc] [Ks]
krytalex: checks
igorkabmw: checks
*** RIVER *** [7h 5d Kc Ks] [Qs]
krytalex: checks
igorkabmw: bets $6
krytalex: folds
Uncalled bet ($6) returned to igorkabmw
igorkabmw collected $5.88 from pot
*** SUMMARY ***
Total pot $6 | Rake $0.12
Board [7h 5d Kc Ks Qs]
Seat 3: krytalex (big blind) folded on the River
Seat 4: igorkabmw (button) (small blind) collected ($5.88)


PokerStars Hand #171737291336:  Hold'em Limit ($3/$6 USD) - 2017/06/13 16:40:37 ET
Table 'Rafita II' 6-max Seat #4 is the button
Seat 3: krytalex ($109.01 in chips)
Seat 4: igorkabmw ($26.88 in chips)
igorkabmw: posts small blind $1
krytalex: posts big blind $3
*** HOLE CARDS ***
igorkabmw: raises $3 to $6
krytalex: calls $3
*** FLOP *** [Qd Jc 8s]
krytalex: checks
igorkabmw: checks
*** TURN *** [Qd Jc 8s] [Kd]
krytalex: checks
igorkabmw: checks
*** RIVER *** [Qd Jc 8s Kd] [7h]
krytalex: checks
igorkabmw: checks
*** SHOW DOWN ***
krytalex: shows [Jd 4h] (a pair of Jacks)
igorkabmw: mucks hand
krytalex collected $11.76 from pot
*** SUMMARY ***
Total pot $12 | Rake $0.24
Board [Qd Jc 8s Kd 7h]
Seat 3: krytalex (big blind) showed [Jd 4h] and won ($11.76) with a pair of Jacks
Seat 4: igorkabmw (button) (small blind) mucked


PokerStars Hand #171737268600:  Hold'em Limit ($3/$6 USD) - 2017/06/13 16:40:10 ET
Table 'Rafita II' 6-max Seat #3 is the button
Seat 3: krytalex ($103.25 in chips)
Seat 4: igorkabmw ($32.88 in chips)
krytalex: posts small blind $1
igorkabmw: posts big blind $3
*** HOLE CARDS ***
krytalex: raises $3 to $6
igorkabmw: calls $3
*** FLOP *** [Js 8d Td]
igorkabmw: checks
krytalex: bets $3
igorkabmw: folds
Uncalled bet ($3) returned to krytalex
krytalex collected $11.76 from pot
*** SUMMARY ***
Total pot $12 | Rake $0.24
Board [Js 8d Td]
Seat 3: krytalex (button) (small blind) collected ($11.76)
Seat 4: igorkabmw (big blind) folded on the Flop


PokerStars Hand #171737323908:  Hold'em Limit ($3/$6 USD) - 2017/06/13 16:41:17 ET
Table 'Rafita II' 6-max Seat #4 is the button
Seat 3: krytalex ($113.77 in chips)
Seat 4: igorkabmw ($21.88 in chips)
igorkabmw: posts small blind $1
krytalex: posts big blind $3
*** HOLE CARDS ***
igorkabmw: raises $3 to $6
krytalex: calls $3
*** FLOP *** [6h Ac Ts]
krytalex: checks
igorkabmw: checks
*** TURN *** [6h Ac Ts] [Ah]
krytalex: bets $6
igorkabmw: calls $6
*** RIVER *** [6h Ac Ts Ah] [Ad]
krytalex: bets $6
igorkabmw: raises $3.88 to $9.88 and is all-in
krytalex: calls $3.88
*** SHOW DOWN ***
igorkabmw: shows [7d Ks] (three of a kind, Aces)
krytalex: shows [8s Tc] (a full house, Aces full of Tens)
krytalex collected $43.26 from pot
*** SUMMARY ***
Total pot $43.76 | Rake $0.50
Board [6h Ac Ts Ah Ad]
Seat 3: krytalex (big blind) showed [8s Tc] and won ($43.26) with a full house, Aces full of Tens
Seat 4: igorkabmw (button) (small blind) showed [7d Ks] and lost with three of a kind, Aces


PokerStars Hand #171737314615:  Hold'em Limit ($3/$6 USD) - 2017/06/13 16:41:05 ET
Table 'Rafita II' 6-max Seat #3 is the button
Seat 3: krytalex ($114.77 in chips)
Seat 4: igorkabmw ($20.88 in chips)
krytalex: posts small blind $1
igorkabmw: posts big blind $3
*** HOLE CARDS ***
krytalex: folds
Uncalled bet ($2) returned to igorkabmw
igorkabmw collected $2 from pot
*** SUMMARY ***
Total pot $2 | Rake $0
Seat 3: krytalex (button) (small blind) folded before Flop
Seat 4: igorkabmw (big blind) collected ($2)


