PokerStars Hand #160346899285:  Hold'em Limit ($3/$6 USD) - 2016/10/23 17:19:59 ET
Table 'Siwa' 6-max Seat #1 is the button
Seat 1: Zubasa07 ($502.76 in chips)
Seat 3: pitbull1955 ($117 in chips)
Zubasa07: posts small blind $1
pitbull1955: posts big blind $3
*** HOLE CARDS ***
Zubasa07: raises $3 to $6
pitbull1955: calls $3
*** FLOP *** [Qc Ah 9h]
pitbull1955: checks
Zubasa07: checks
*** TURN *** [Qc Ah 9h] [4s]
pitbull1955: checks
Zubasa07: checks
*** RIVER *** [Qc Ah 9h 4s] [Qs]
pitbull1955: bets $6
Zubasa07: calls $6
*** SHOW DOWN ***
pitbull1955: shows [8d Js] (a pair of Queens)
Zubasa07: shows [Td Tc] (two pair, Queens and Tens)
Zubasa07 collected $23.52 from pot
*** SUMMARY ***
Total pot $24 | Rake $0.48
Board [Qc Ah 9h 4s Qs]
Seat 1: Zubasa07 (button) (small blind) showed [Td Tc] and won ($23.52) with two pair, Queens and Tens
Seat 3: pitbull1955 (big blind) showed [8d Js] and lost with a pair of Queens


PokerStars Hand #160346928116:  Hold'em Limit ($3/$6 USD) - 2016/10/23 17:20:31 ET
Table 'Siwa' 6-max Seat #3 is the button
Seat 1: Zubasa07 ($514.28 in chips)
Seat 3: pitbull1955 ($105 in chips)
pitbull1955: posts small blind $1
Zubasa07: posts big blind $3
*** HOLE CARDS ***
pitbull1955: raises $3 to $6
Zubasa07: calls $3
*** FLOP *** [8c Ks 9s]
Zubasa07: checks
pitbull1955: bets $3
Zubasa07: calls $3
*** TURN *** [8c Ks 9s] [Qc]
Zubasa07: checks
pitbull1955: bets $6
Zubasa07: calls $6
*** RIVER *** [8c Ks 9s Qc] [8d]
Zubasa07: checks
pitbull1955: checks
*** SHOW DOWN ***
Zubasa07: shows [7d Jc] (a pair of Eights)
pitbull1955: shows [4d Kc] (two pair, Kings and Eights)
pitbull1955 collected $29.50 from pot
*** SUMMARY ***
Total pot $30 | Rake $0.50
Board [8c Ks 9s Qc 8d]
Seat 1: Zubasa07 (big blind) showed [7d Jc] and lost with a pair of Eights
Seat 3: pitbull1955 (button) (small blind) showed [4d Kc] and won ($29.50) with two pair, Kings and Eights


PokerStars Hand #160346969448:  Hold'em Limit ($3/$6 USD) - 2016/10/23 17:21:18 ET
Table 'Siwa' 6-max Seat #1 is the button
Seat 1: Zubasa07 ($499.28 in chips)
Seat 3: pitbull1955 ($119.50 in chips)
Zubasa07: posts small blind $1
pitbull1955: posts big blind $3
*** HOLE CARDS ***
Zubasa07: raises $3 to $6
pitbull1955: folds
Uncalled bet ($3) returned to Zubasa07
Zubasa07 collected $6 from pot
Zubasa07: doesn't show hand
*** SUMMARY ***
Total pot $6 | Rake $0
Seat 1: Zubasa07 (button) (small blind) collected ($6)
Seat 3: pitbull1955 (big blind) folded before Flop


PokerStars Hand #160346978854:  Hold'em Limit ($3/$6 USD) - 2016/10/23 17:21:29 ET
Table 'Siwa' 6-max Seat #3 is the button
Seat 1: Zubasa07 ($502.28 in chips)
Seat 3: pitbull1955 ($116.50 in chips)
pitbull1955: posts small blind $1
Zubasa07: posts big blind $3
*** HOLE CARDS ***
pitbull1955: folds
Uncalled bet ($2) returned to Zubasa07
Zubasa07 collected $2 from pot
Zubasa07: doesn't show hand
*** SUMMARY ***
Total pot $2 | Rake $0
Seat 1: Zubasa07 (big blind) collected ($2)
Seat 3: pitbull1955 (button) (small blind) folded before Flop


PokerStars Hand #160347011973:  Hold'em Limit ($3/$6 USD) - 2016/10/23 17:22:07 ET
Table 'Siwa' 6-max Seat #1 is the button
Seat 1: Zubasa07 ($483.28 in chips)
Seat 3: pitbull1955 ($135 in chips)
Zubasa07: posts small blind $1
pitbull1955: posts big blind $3
*** HOLE CARDS ***
Zubasa07: folds
Uncalled bet ($2) returned to pitbull1955
pitbull1955 collected $2 from pot
pitbull1955: doesn't show hand
*** SUMMARY ***
Total pot $2 | Rake $0
Seat 1: Zubasa07 (button) (small blind) folded before Flop
Seat 3: pitbull1955 (big blind) collected ($2)


PokerStars Hand #160347003713:  Hold'em Limit ($3/$6 USD) - 2016/10/23 17:21:58 ET
Table 'Siwa' 6-max Seat #3 is the button
Seat 1: Zubasa07 ($482.28 in chips)
Seat 3: pitbull1955 ($136 in chips)
pitbull1955: posts small blind $1
Zubasa07: posts big blind $3
*** HOLE CARDS ***
pitbull1955: folds
Uncalled bet ($2) returned to Zubasa07
Zubasa07 collected $2 from pot
Zubasa07: doesn't show hand
*** SUMMARY ***
Total pot $2 | Rake $0
Seat 1: Zubasa07 (big blind) collected ($2)
Seat 3: pitbull1955 (button) (small blind) folded before Flop


PokerStars Hand #160346982999:  Hold'em Limit ($3/$6 USD) - 2016/10/23 17:21:34 ET
Table 'Siwa' 6-max Seat #1 is the button
Seat 1: Zubasa07 ($503.28 in chips)
Seat 3: pitbull1955 ($115.50 in chips)
Zubasa07: posts small blind $1
pitbull1955: posts big blind $3
*** HOLE CARDS ***
Zubasa07: raises $3 to $6
pitbull1955: calls $3
*** FLOP *** [9s Td Jd]
pitbull1955: bets $3
Zubasa07: calls $3
*** TURN *** [9s Td Jd] [5c]
pitbull1955: bets $6
Zubasa07: calls $6
*** RIVER *** [9s Td Jd 5c] [Qh]
pitbull1955: bets $6
Zubasa07: calls $6
*** SHOW DOWN ***
pitbull1955: shows [8c Js] (a straight, Eight to Queen)
Zubasa07: mucks hand
pitbull1955 collected $41.50 from pot
*** SUMMARY ***
Total pot $42 | Rake $0.50
Board [9s Td Jd 5c Qh]
Seat 1: Zubasa07 (button) (small blind) mucked
Seat 3: pitbull1955 (big blind) showed [8c Js] and won ($41.50) with a straight, Eight to Queen


PokerStars Hand #160347016075:  Hold'em Limit ($3/$6 USD) - 2016/10/23 17:22:12 ET
Table 'Siwa' 6-max Seat #3 is the button
Seat 1: Zubasa07 ($482.28 in chips)
Seat 3: pitbull1955 ($136 in chips)
pitbull1955: posts small blind $1
Zubasa07: posts big blind $3
*** HOLE CARDS ***
pitbull1955: raises $3 to $6
Zubasa07: calls $3
*** FLOP *** [Qs 4c Kc]
Zubasa07: checks
pitbull1955: bets $3
Zubasa07: raises $3 to $6
pitbull1955: calls $3
*** TURN *** [Qs 4c Kc] [6c]
Zubasa07: checks
pitbull1955: checks
*** RIVER *** [Qs 4c Kc 6c] [Ks]
Zubasa07: checks
pitbull1955: checks
*** SHOW DOWN ***
Zubasa07: shows [Jd 4s] (two pair, Kings and Fours)
pitbull1955: shows [9d 9s] (two pair, Kings and Nines)
pitbull1955 collected $23.52 from pot
*** SUMMARY ***
Total pot $24 | Rake $0.48
Board [Qs 4c Kc 6c Ks]
Seat 1: Zubasa07 (big blind) showed [Jd 4s] and lost with two pair, Kings and Fours
Seat 3: pitbull1955 (button) (small blind) showed [9d 9s] and won ($23.52) with two pair, Kings and Nines


PokerStars Hand #160347065121:  Hold'em Limit ($3/$6 USD) - 2016/10/23 17:23:07 ET
Table 'Siwa' 6-max Seat #1 is the button
Seat 1: Zubasa07 ($470.28 in chips)
Seat 3: pitbull1955 ($147.52 in chips)
Zubasa07: posts small blind $1
pitbull1955: posts big blind $3
*** HOLE CARDS ***
Zubasa07: raises $3 to $6
pitbull1955: calls $3
*** FLOP *** [7c Ah Th]
pitbull1955: checks
Zubasa07: bets $3
pitbull1955: calls $3
*** TURN *** [7c Ah Th] [6s]
pitbull1955: checks
Zubasa07: bets $6
pitbull1955: calls $6
*** RIVER *** [7c Ah Th 6s] [4s]
pitbull1955: bets $6
Zubasa07: raises $6 to $12
pitbull1955: raises $6 to $18
Masqb joins the table at seat #4
Zubasa07: raises $6 to $24
Betting is capped
pitbull1955: calls $6
*** SHOW DOWN ***
Zubasa07: shows [8h 5s] (a straight, Four to Eight)
pitbull1955: mucks hand
Zubasa07 collected $77.50 from pot
*** SUMMARY ***
Total pot $78 | Rake $0.50
Board [7c Ah Th 6s 4s]
Seat 1: Zubasa07 (button) (small blind) showed [8h 5s] and won ($77.50) with a straight, Four to Eight
Seat 3: pitbull1955 (big blind) mucked


