PokerStars Hand #149993587510:  Hold'em Limit ($3/$6 USD) - 2016/03/07 14:10:51 ET
Table 'Tabora' 6-max Seat #3 is the button
Seat 3: carmello774 ($113 in chips)
Seat 4: craaa ($126.76 in chips)
carmello774: posts small blind $1
craaa: posts big blind $3
*** HOLE CARDS ***
carmello774: raises $3 to $6
craaa: calls $3
*** FLOP *** [6s Jc 4s]
craaa: checks
carmello774: checks
*** TURN *** [6s Jc 4s] [7d]
craaa: bets $6
carmello774: calls $6
*** RIVER *** [6s Jc 4s 7d] [Jh]
craaa: bets $6
carmello774: calls $6
*** SHOW DOWN ***
craaa: shows [6d Qs] (two pair, Jacks and Sixes)
carmello774: mucks hand
craaa collected $35.50 from pot
*** SUMMARY ***
Total pot $36 | Rake $0.50
Board [6s Jc 4s 7d Jh]
Seat 3: carmello774 (button) (small blind) mucked
Seat 4: craaa (big blind) showed [6d Qs] and won ($35.50) with two pair, Jacks and Sixes


PokerStars Hand #149993604062:  Hold'em Limit ($3/$6 USD) - 2016/03/07 14:11:08 ET
Table 'Tabora' 6-max Seat #4 is the button
Seat 3: carmello774 ($95 in chips)
Seat 4: craaa ($144.26 in chips)
craaa: posts small blind $1
carmello774: posts big blind $3
*** HOLE CARDS ***
craaa: raises $3 to $6
carmello774: calls $3
*** FLOP *** [7h Qs 3d]
carmello774: checks
craaa: bets $3
carmello774: raises $3 to $6
craaa: folds
Uncalled bet ($3) returned to carmello774
carmello774 collected $17.64 from pot
carmello774: doesn't show hand
*** SUMMARY ***
Total pot $18 | Rake $0.36
Board [7h Qs 3d]
Seat 3: carmello774 (big blind) collected ($17.64)
Seat 4: craaa (button) (small blind) folded on the Flop


PokerStars Hand #149993627316:  Hold'em Limit ($3/$6 USD) - 2016/03/07 14:11:33 ET
Table 'Tabora' 6-max Seat #3 is the button
Seat 3: carmello774 ($103.64 in chips)
Seat 4: craaa ($135.26 in chips)
carmello774: posts small blind $1
craaa: posts big blind $3
*** HOLE CARDS ***
carmello774: raises $3 to $6
craaa: calls $3
*** FLOP *** [3c 8d Kc]
craaa: checks
carmello774: bets $3
craaa: calls $3
*** TURN *** [3c 8d Kc] [3d]
craaa: checks
carmello774: bets $6
craaa: raises $6 to $12
carmello774: calls $6
*** RIVER *** [3c 8d Kc 3d] [7d]
craaa: bets $6
carmello774: raises $6 to $12
craaa: calls $6
*** SHOW DOWN ***
carmello774: shows [4d Kd] (a flush, King high)
craaa: mucks hand
carmello774 collected $65.50 from pot
*** SUMMARY ***
Total pot $66 | Rake $0.50
Board [3c 8d Kc 3d 7d]
Seat 3: carmello774 (button) (small blind) showed [4d Kd] and won ($65.50) with a flush, King high
Seat 4: craaa (big blind) mucked


PokerStars Hand #149993717312:  Hold'em Limit ($3/$6 USD) - 2016/03/07 14:13:07 ET
Table 'Tabora' 6-max Seat #3 is the button
Seat 3: carmello774 ($130.14 in chips)
Seat 4: craaa ($108.02 in chips)
carmello774: posts small blind $1
craaa: posts big blind $3
*** HOLE CARDS ***
carmello774: raises $3 to $6
craaa: folds
Uncalled bet ($3) returned to carmello774
carmello774 collected $6 from pot
carmello774: doesn't show hand
*** SUMMARY ***
Total pot $6 | Rake $0
Seat 3: carmello774 (button) (small blind) collected ($6)
Seat 4: craaa (big blind) folded before Flop


PokerStars Hand #149993723316:  Hold'em Limit ($3/$6 USD) - 2016/03/07 14:13:14 ET
Table 'Tabora' 6-max Seat #4 is the button
Seat 3: carmello774 ($133.14 in chips)
Seat 4: craaa ($105.02 in chips)
craaa: posts small blind $1
carmello774: posts big blind $3
*** HOLE CARDS ***
craaa: raises $3 to $6
carmello774: folds
Uncalled bet ($3) returned to craaa
craaa collected $6 from pot
craaa: doesn't show hand
*** SUMMARY ***
Total pot $6 | Rake $0
Seat 3: carmello774 (big blind) folded before Flop
Seat 4: craaa (button) (small blind) collected ($6)


PokerStars Hand #149993677750:  Hold'em Limit ($3/$6 USD) - 2016/03/07 14:12:26 ET
Table 'Tabora' 6-max Seat #4 is the button
Seat 3: carmello774 ($136.14 in chips)
Seat 4: craaa ($102.26 in chips)
craaa: posts small blind $1
carmello774: posts big blind $3
*** HOLE CARDS ***
craaa: raises $3 to $6
carmello774: calls $3
*** FLOP *** [9d As Kd]
carmello774: checks
craaa: bets $3
carmello774: folds
Uncalled bet ($3) returned to craaa
craaa collected $11.76 from pot
craaa: doesn't show hand
*** SUMMARY ***
Total pot $12 | Rake $0.24
Board [9d As Kd]
Seat 3: carmello774 (big blind) folded on the Flop
Seat 4: craaa (button) (small blind) collected ($11.76)


PokerStars Hand #149993733304:  Hold'em Limit ($3/$6 USD) - 2016/03/07 14:13:24 ET
Table 'Tabora' 6-max Seat #3 is the button
Seat 3: carmello774 ($130.14 in chips)
Seat 4: craaa ($108.02 in chips)
carmello774: posts small blind $1
craaa: posts big blind $3
*** HOLE CARDS ***
carmello774: raises $3 to $6
craaa: calls $3
*** FLOP *** [8d 8c 4s]
craaa: checks
carmello774: bets $3
craaa: folds
Uncalled bet ($3) returned to carmello774
carmello774 collected $11.76 from pot
carmello774: doesn't show hand
*** SUMMARY ***
Total pot $12 | Rake $0.24
Board [8d 8c 4s]
Seat 3: carmello774 (button) (small blind) collected ($11.76)
Seat 4: craaa (big blind) folded on the Flop


PokerStars Hand #149993815786:  Hold'em Limit ($3/$6 USD) - 2016/03/07 14:14:51 ET
Table 'Tabora' 6-max Seat #4 is the button
Seat 3: carmello774 ($163.40 in chips)
Seat 4: craaa ($74.02 in chips)
craaa: posts small blind $1
carmello774: posts big blind $3
*** HOLE CARDS ***
craaa: raises $3 to $6
carmello774: calls $3
*** FLOP *** [9d Jh 6c]
carmello774: checks
craaa: bets $3
carmello774: folds
Uncalled bet ($3) returned to craaa
craaa collected $11.76 from pot
craaa: doesn't show hand
*** SUMMARY ***
Total pot $12 | Rake $0.24
Board [9d Jh 6c]
Seat 3: carmello774 (big blind) folded on the Flop
Seat 4: craaa (button) (small blind) collected ($11.76)


PokerStars Hand #149993792349:  Hold'em Limit ($3/$6 USD) - 2016/03/07 14:14:26 ET
Table 'Tabora' 6-max Seat #3 is the button
Seat 3: carmello774 ($136.90 in chips)
Seat 4: craaa ($101.02 in chips)
carmello774: posts small blind $1
craaa: posts big blind $3
*** HOLE CARDS ***
carmello774: raises $3 to $6
craaa: calls $3
*** FLOP *** [8d 4d As]
craaa: checks
carmello774: bets $3
craaa: calls $3
*** TURN *** [8d 4d As] [Jh]
craaa: checks
carmello774: bets $6
craaa: raises $6 to $12
carmello774: calls $6
*** RIVER *** [8d 4d As Jh] [Ah]
craaa: bets $6
carmello774: calls $6
*** SHOW DOWN ***
craaa: shows [4h Js] (two pair, Aces and Jacks)
carmello774: shows [Ks Kc] (two pair, Aces and Kings)
carmello774 collected $53.50 from pot
*** SUMMARY ***
Total pot $54 | Rake $0.50
Board [8d 4d As Jh Ah]
Seat 3: carmello774 (button) (small blind) showed [Ks Kc] and won ($53.50) with two pair, Aces and Kings
Seat 4: craaa (big blind) showed [4h Js] and lost with two pair, Aces and Jacks


PokerStars Hand #149993834923:  Hold'em Limit ($3/$6 USD) - 2016/03/07 14:15:10 ET
Table 'Tabora' 6-max Seat #3 is the button
Seat 3: carmello774 ($157.40 in chips)
Seat 4: craaa ($79.78 in chips)
carmello774: posts small blind $1
craaa: posts big blind $3
*** HOLE CARDS ***
carmello774: raises $3 to $6
craaa: raises $3 to $9
carmello774: calls $3
*** FLOP *** [Kc 3h 4d]
craaa: bets $3
carmello774: raises $3 to $6
craaa: folds
Uncalled bet ($3) returned to carmello774
carmello774 collected $23.52 from pot
carmello774: doesn't show hand
*** SUMMARY ***
Total pot $24 | Rake $0.48
Board [Kc 3h 4d]
Seat 3: carmello774 (button) (small blind) collected ($23.52)
Seat 4: craaa (big blind) folded on the Flop


PokerStars Hand #149993852820:  Hold'em Limit ($3/$6 USD) - 2016/03/07 14:15:29 ET
Table 'Tabora' 6-max Seat #4 is the button
Seat 3: carmello774 ($168.92 in chips)
Seat 4: craaa ($67.78 in chips)
craaa: posts small blind $1
carmello774: posts big blind $3
*** HOLE CARDS ***
craaa: folds
Uncalled bet ($2) returned to carmello774
carmello774 collected $2 from pot
carmello774: doesn't show hand
*** SUMMARY ***
Total pot $2 | Rake $0
Seat 3: carmello774 (big blind) collected ($2)
Seat 4: craaa (button) (small blind) folded before Flop


PokerStars Hand #149993910785:  Hold'em Limit ($3/$6 USD) - 2016/03/07 14:16:30 ET
Table 'Tabora' 6-max Seat #3 is the button
Seat 3: carmello774 ($169.68 in chips)
Seat 4: craaa ($66.54 in chips)
carmello774: posts small blind $1
craaa: posts big blind $3
*** HOLE CARDS ***
carmello774: folds
Uncalled bet ($2) returned to craaa
craaa collected $2 from pot
craaa: doesn't show hand
*** SUMMARY ***
Total pot $2 | Rake $0
Seat 3: carmello774 (button) (small blind) folded before Flop
Seat 4: craaa (big blind) collected ($2)


PokerStars Hand #149993861856:  Hold'em Limit ($3/$6 USD) - 2016/03/07 14:15:39 ET
Table 'Tabora' 6-max Seat #3 is the button
Seat 3: carmello774 ($169.92 in chips)
Seat 4: craaa ($66.78 in chips)
carmello774: posts small blind $1
craaa: posts big blind $3
*** HOLE CARDS ***
carmello774: raises $3 to $6
craaa: calls $3
*** FLOP *** [4d 7c 6h]
craaa: checks
carmello774: bets $3
craaa: folds
Uncalled bet ($3) returned to carmello774
carmello774 collected $11.76 from pot
carmello774: doesn't show hand
*** SUMMARY ***
Total pot $12 | Rake $0.24
Board [4d 7c 6h]
Seat 3: carmello774 (button) (small blind) collected ($11.76)
Seat 4: craaa (big blind) folded on the Flop


PokerStars Hand #149993901728:  Hold'em Limit ($3/$6 USD) - 2016/03/07 14:16:20 ET
Table 'Tabora' 6-max Seat #4 is the button
Seat 3: carmello774 ($175.68 in chips)
Seat 4: craaa ($60.78 in chips)
craaa: posts small blind $1
carmello774: posts big blind $3
*** HOLE CARDS ***
craaa: raises $3 to $6
carmello774: calls $3
*** FLOP *** [7d 5c 4c]
carmello774: checks
craaa: bets $3
carmello774: folds
Uncalled bet ($3) returned to craaa
craaa collected $11.76 from pot
craaa: doesn't show hand
*** SUMMARY ***
Total pot $12 | Rake $0.24
Board [7d 5c 4c]
Seat 3: carmello774 (big blind) folded on the Flop
Seat 4: craaa (button) (small blind) collected ($11.76)


PokerStars Hand #149993928959:  Hold'em Limit ($3/$6 USD) - 2016/03/07 14:16:48 ET
Table 'Tabora' 6-max Seat #4 is the button
Seat 3: carmello774 ($165.68 in chips)
Seat 4: craaa ($70.30 in chips)
craaa: posts small blind $1
carmello774: posts big blind $3
*** HOLE CARDS ***
craaa: raises $3 to $6
carmello774: folds
Uncalled bet ($3) returned to craaa
craaa collected $6 from pot
craaa: doesn't show hand
*** SUMMARY ***
Total pot $6 | Rake $0
Seat 3: carmello774 (big blind) folded before Flop
Seat 4: craaa (button) (small blind) collected ($6)


PokerStars Hand #149993938011:  Hold'em Limit ($3/$6 USD) - 2016/03/07 14:16:58 ET
Table 'Tabora' 6-max Seat #3 is the button
Seat 3: carmello774 ($162.68 in chips)
Seat 4: craaa ($73.30 in chips)
carmello774: posts small blind $1
craaa: posts big blind $3
*** HOLE CARDS ***
carmello774: raises $3 to $6
craaa: calls $3
*** FLOP *** [Jd Qd 4s]
craaa: checks
carmello774: bets $3
craaa: calls $3
*** TURN *** [Jd Qd 4s] [4c]
craaa: checks
carmello774: bets $6
craaa: calls $6
*** RIVER *** [Jd Qd 4s 4c] [3d]
craaa: checks
carmello774: checks
*** SHOW DOWN ***
craaa: shows [Ac 5s] (a pair of Fours)
carmello774: mucks hand
craaa collected $29.50 from pot
*** SUMMARY ***
Total pot $30 | Rake $0.50
Board [Jd Qd 4s 4c 3d]
Seat 3: carmello774 (button) (small blind) mucked
Seat 4: craaa (big blind) showed [Ac 5s] and won ($29.50) with a pair of Fours


PokerStars Hand #149993923513:  Hold'em Limit ($3/$6 USD) - 2016/03/07 14:16:43 ET
Table 'Tabora' 6-max Seat #3 is the button
Seat 3: carmello774 ($162.68 in chips)
Seat 4: craaa ($73.30 in chips)
carmello774: posts small blind $1
craaa: posts big blind $3
*** HOLE CARDS ***
carmello774: raises $3 to $6
craaa: folds
Uncalled bet ($3) returned to carmello774
carmello774 collected $6 from pot
*** SUMMARY ***
Total pot $6 | Rake $0
Seat 3: carmello774 (button) (small blind) collected ($6)
Seat 4: craaa (big blind) folded before Flop


PokerStars Hand #149993915226:  Hold'em Limit ($3/$6 USD) - 2016/03/07 14:16:34 ET
Table 'Tabora' 6-max Seat #4 is the button
Seat 3: carmello774 ($168.68 in chips)
Seat 4: craaa ($67.54 in chips)
craaa: posts small blind $1
carmello774: posts big blind $3
*** HOLE CARDS ***
craaa: raises $3 to $6
carmello774: calls $3
*** FLOP *** [4c Kh Ah]
carmello774: checks
craaa: bets $3
carmello774: folds
Uncalled bet ($3) returned to craaa
craaa collected $11.76 from pot
craaa: doesn't show hand
*** SUMMARY ***
Total pot $12 | Rake $0.24
Board [4c Kh Ah]
Seat 3: carmello774 (big blind) folded on the Flop
Seat 4: craaa (button) (small blind) collected ($11.76)


PokerStars Hand #149993979113:  Hold'em Limit ($3/$6 USD) - 2016/03/07 14:17:41 ET
Table 'Tabora' 6-max Seat #4 is the button
Seat 3: carmello774 ($147.68 in chips)
Seat 4: craaa ($87.80 in chips)
craaa: posts small blind $1
carmello774: posts big blind $3
*** HOLE CARDS ***
craaa: raises $3 to $6
carmello774: calls $3
*** FLOP *** [3c Ad 7d]
carmello774: checks
craaa: bets $3
carmello774: raises $3 to $6
craaa: calls $3
*** TURN *** [3c Ad 7d] [4s]
carmello774: bets $6
craaa: folds
Uncalled bet ($6) returned to carmello774
carmello774 collected $23.52 from pot
carmello774: doesn't show hand
*** SUMMARY ***
Total pot $24 | Rake $0.48
Board [3c Ad 7d 4s]
Seat 3: carmello774 (big blind) collected ($23.52)
Seat 4: craaa (button) (small blind) folded on the Turn


PokerStars Hand #149994011623:  Hold'em Limit ($3/$6 USD) - 2016/03/07 14:18:14 ET
Table 'Tabora' 6-max Seat #3 is the button
Seat 3: carmello774 ($159.20 in chips)
Seat 4: craaa ($75.80 in chips)
carmello774: posts small blind $1
craaa: posts big blind $3
*** HOLE CARDS ***
carmello774: raises $3 to $6
craaa: raises $3 to $9
carmello774: calls $3
*** FLOP *** [8d 8s 8c]
craaa: bets $3
carmello774: calls $3
*** TURN *** [8d 8s 8c] [5h]
craaa: bets $6
carmello774: calls $6
*** RIVER *** [8d 8s 8c 5h] [Jc]
craaa: checks
carmello774: checks
*** SHOW DOWN ***
craaa: shows [3c Ac] (three of a kind, Eights)
carmello774: mucks hand
craaa collected $35.50 from pot
*** SUMMARY ***
Total pot $36 | Rake $0.50
Board [8d 8s 8c 5h Jc]
Seat 3: carmello774 (button) (small blind) mucked
Seat 4: craaa (big blind) showed [3c Ac] and won ($35.50) with three of a kind, Eights


PokerStars Hand #149994027267:  Hold'em Limit ($3/$6 USD) - 2016/03/07 14:18:31 ET
Table 'Tabora' 6-max Seat #4 is the button
Seat 3: carmello774 ($141.20 in chips)
Seat 4: craaa ($93.30 in chips)
craaa: posts small blind $1
carmello774: posts big blind $3
*** HOLE CARDS ***
craaa: raises $3 to $6
carmello774: calls $3
*** FLOP *** [Jh Th 6d]
carmello774: checks
craaa: checks
*** TURN *** [Jh Th 6d] [4d]
carmello774: bets $6
craaa: calls $6
*** RIVER *** [Jh Th 6d 4d] [7s]
carmello774: bets $6
craaa: folds
Uncalled bet ($6) returned to carmello774
carmello774 collected $23.52 from pot
carmello774: doesn't show hand
*** SUMMARY ***
Total pot $24 | Rake $0.48
Board [Jh Th 6d 4d 7s]
Seat 3: carmello774 (big blind) collected ($23.52)
Seat 4: craaa (button) (small blind) folded on the River


PokerStars Hand #150003777869:  Hold'em Limit ($3/$6 USD) - 2016/03/07 17:01:03 ET
Table 'Tabora' 6-max Seat #4 is the button
Seat 4: pompa4 ($134.50 in chips)
Seat 6: Chessnok ($62.25 in chips)
pompa4: posts small blind $1
Chessnok: posts big blind $3
*** HOLE CARDS ***
pompa4: calls $2
Chessnok: checks
*** FLOP *** [8h 9h Td]
Chessnok: bets $3
pompa4: calls $3
*** TURN *** [8h 9h Td] [Kd]
Chessnok: checks
pompa4: bets $6
Chessnok: calls $6
*** RIVER *** [8h 9h Td Kd] [5s]
Chessnok: bets $6
ice0034 leaves the table
pompa4: calls $6
*** SHOW DOWN ***
Chessnok: shows [Tc 3d] (a pair of Tens)
pompa4: mucks hand
Chessnok collected $35.50 from pot
*** SUMMARY ***
Total pot $36 | Rake $0.50
Board [8h 9h Td Kd 5s]
Seat 4: pompa4 (button) (small blind) mucked
Seat 6: Chessnok (big blind) showed [Tc 3d] and won ($35.50) with a pair of Tens


PokerStars Hand #150003753071:  Hold'em Limit ($3/$6 USD) - 2016/03/07 17:00:35 ET
Table 'Tabora' 6-max Seat #6 is the button
Seat 4: pompa4 ($120 in chips)
Seat 6: Chessnok ($77.25 in chips)
Chessnok: posts small blind $1
pompa4: posts big blind $3
*** HOLE CARDS ***
Chessnok: raises $3 to $6
pompa4: calls $3
*** FLOP *** [6d 9h Jd]
pompa4: checks
Chessnok: bets $3
pompa4: calls $3
*** TURN *** [6d 9h Jd] [7s]
pompa4: checks
Chessnok: bets $6
pompa4: calls $6
*** RIVER *** [6d 9h Jd 7s] [Ad]
pompa4: bets $6
Chessnok: folds
Uncalled bet ($6) returned to pompa4
pompa4 collected $29.50 from pot
pompa4: doesn't show hand
*** SUMMARY ***
Total pot $30 | Rake $0.50
Board [6d 9h Jd 7s Ad]
Seat 4: pompa4 (big blind) collected ($29.50)
Seat 6: Chessnok (button) (small blind) folded on the River


PokerStars Hand #150003840218:  Hold'em Limit ($3/$6 USD) - 2016/03/07 17:02:08 ET
Table 'Tabora' 6-max Seat #6 is the button
Seat 4: pompa4 ($104.14 in chips)
Seat 6: Chessnok ($91.25 in chips)
Chessnok: posts small blind $1
pompa4: posts big blind $3
*** HOLE CARDS ***
Chessnok: raises $3 to $6
pompa4: raises $3 to $9
Chessnok: calls $3
*** FLOP *** [7c Kd 3h]
pompa4: bets $3
Chessnok: calls $3
*** TURN *** [7c Kd 3h] [4c]
pompa4: bets $6
Chessnok: calls $6
*** RIVER *** [7c Kd 3h 4c] [Qd]
pompa4: bets $6
Chessnok: calls $6
*** SHOW DOWN ***
pompa4: shows [As Jh] (high card Ace)
Chessnok: shows [7d 9d] (a pair of Sevens)
Chessnok collected $47.50 from pot
*** SUMMARY ***
Total pot $48 | Rake $0.50
Board [7c Kd 3h 4c Qd]
Seat 4: pompa4 (big blind) showed [As Jh] and lost with high card Ace
Seat 6: Chessnok (button) (small blind) showed [7d 9d] and won ($47.50) with a pair of Sevens


PokerStars Hand #150003821604:  Hold'em Limit ($3/$6 USD) - 2016/03/07 17:01:50 ET
Table 'Tabora' 6-max Seat #4 is the button
Seat 4: pompa4 ($125.14 in chips)
Seat 6: Chessnok ($70.75 in chips)
pompa4: posts small blind $1
Chessnok: posts big blind $3
*** HOLE CARDS ***
pompa4: calls $2
Chessnok: raises $3 to $6
pompa4: calls $3
*** FLOP *** [Js 6d Qc]
Chessnok: bets $3
pompa4: calls $3
*** TURN *** [Js 6d Qc] [2c]
Chessnok: bets $6
pompa4: calls $6
*** RIVER *** [Js 6d Qc 2c] [9d]
Chessnok: bets $6
pompa4: calls $6
*** SHOW DOWN ***
Chessnok: shows [8s Jh] (a pair of Jacks)
pompa4: mucks hand
Chessnok collected $41.50 from pot
*** SUMMARY ***
Total pot $42 | Rake $0.50
Board [Js 6d Qc 2c 9d]
Seat 4: pompa4 (button) (small blind) mucked
Seat 6: Chessnok (big blind) showed [8s Jh] and won ($41.50) with a pair of Jacks


PokerStars Hand #150003801633:  Hold'em Limit ($3/$6 USD) - 2016/03/07 17:01:29 ET
Table 'Tabora' 6-max Seat #6 is the button
Seat 4: pompa4 ($116.50 in chips)
Seat 6: Chessnok ($79.75 in chips)
Chessnok: posts small blind $1
pompa4: posts big blind $3
*** HOLE CARDS ***
Chessnok: raises $3 to $6
pompa4: calls $3
*** FLOP *** [6h 3c 7c]
pompa4: bets $3
Chessnok: calls $3
*** TURN *** [6h 3c 7c] [4d]
pompa4: bets $6
Chessnok: folds
Uncalled bet ($6) returned to pompa4
pompa4 collected $17.64 from pot
pompa4: doesn't show hand
*** SUMMARY ***
Total pot $18 | Rake $0.36
Board [6h 3c 7c 4d]
Seat 4: pompa4 (big blind) collected ($17.64)
Seat 6: Chessnok (button) (small blind) folded on the Turn


