PokerStars Hand #171803274235:  Hold'em Limit ($3/$6 USD) - 2017/06/15 10:26:15 ET
Table 'Terradas II' 6-max Seat #3 is the button
Seat 3: sim5sim5 ($72 in chips)
Seat 5: Aragorn ll ($33.42 in chips)
sim5sim5: posts small blind $1
Aragorn ll: posts big blind $3
*** HOLE CARDS ***
TbIP-TbIP 88 joins the table at seat #6
sim5sim5: raises $3 to $6
Aragorn ll: calls $3
*** FLOP *** [4d Tc 8c]
Aragorn ll: bets $3
sim5sim5: raises $3 to $6
Aragorn ll: raises $3 to $9
sim5sim5: calls $3
*** TURN *** [4d Tc 8c] [6s]
Aragorn ll: bets $6
sim5sim5: calls $6
*** RIVER *** [4d Tc 8c 6s] [Qh]
Aragorn ll: bets $6
sim5sim5: calls $6
*** SHOW DOWN ***
Aragorn ll: shows [5c Ac] (high card Ace)
sim5sim5: shows [9d 8d] (a pair of Eights)
sim5sim5 collected $53.50 from pot
*** SUMMARY ***
Total pot $54 | Rake $0.50
Board [4d Tc 8c 6s Qh]
Seat 3: sim5sim5 (button) (small blind) showed [9d 8d] and won ($53.50) with a pair of Eights
Seat 5: Aragorn ll (big blind) showed [5c Ac] and lost with high card Ace


PokerStars Hand #171803300965:  Hold'em Limit ($3/$6 USD) - 2017/06/15 10:27:00 ET
Table 'Terradas II' 6-max Seat #6 is the button
Seat 3: sim5sim5 ($98.50 in chips)
Seat 6: TbIP-TbIP 88 ($78.03 in chips)
TbIP-TbIP 88: posts small blind $1
sim5sim5: posts big blind $3
*** HOLE CARDS ***
TbIP-TbIP 88: raises $3 to $6
sim5sim5: calls $3
*** FLOP *** [Tc Jc 9d]
sim5sim5: checks
TbIP-TbIP 88: bets $3
sim5sim5: calls $3
*** TURN *** [Tc Jc 9d] [7d]
sim5sim5: checks
TbIP-TbIP 88: checks
*** RIVER *** [Tc Jc 9d 7d] [4d]
sim5sim5: bets $6
nilsyngve joins the table at seat #2
TbIP-TbIP 88: calls $6
*** SHOW DOWN ***
sim5sim5: shows [9h 4h] (two pair, Nines and Fours)
TbIP-TbIP 88: mucks hand
sim5sim5 collected $29.50 from pot
*** SUMMARY ***
Total pot $30 | Rake $0.50
Board [Tc Jc 9d 7d 4d]
Seat 3: sim5sim5 (big blind) showed [9h 4h] and won ($29.50) with two pair, Nines and Fours
Seat 6: TbIP-TbIP 88 (button) (small blind) mucked


PokerStars Hand #171804688232:  Hold'em Limit ($3/$6 USD) - 2017/06/15 11:06:01 ET
Table 'Terradas II' 6-max Seat #3 is the button
Seat 3: aade1ante ($136.75 in chips)
Seat 5: dmkr1992 ($60.56 in chips)
aade1ante: posts small blind $1
DismasX: is sitting out
dmkr1992: posts big blind $3
*** HOLE CARDS ***
aade1ante: raises $3 to $6
dmkr1992: raises $3 to $9
aade1ante: calls $3
*** FLOP *** [2s Ad Qd]
dmkr1992: bets $3
aade1ante: folds
Uncalled bet ($3) returned to dmkr1992
dmkr1992 collected $17.64 from pot
dmkr1992: doesn't show hand
*** SUMMARY ***
Total pot $18 | Rake $0.36
Board [2s Ad Qd]
Seat 3: aade1ante (button) (small blind) folded on the Flop
Seat 5: dmkr1992 (big blind) collected ($17.64)


