PokerStars Hand #169295780998:  Hold'em Limit ($3/$6 USD) - 2017/04/20 4:53:40 ET
Table 'Titius' 6-max Seat #3 is the button
Seat 3: tomasooo29 ($166.99 in chips)
Seat 4: TbIP-TbIP 88 ($77.76 in chips)
tomasooo29: posts small blind $1
TbIP-TbIP 88: posts big blind $3
*** HOLE CARDS ***
tomasooo29: calls $2
TbIP-TbIP 88: checks
*** FLOP *** [Kd 5h As]
TbIP-TbIP 88: bets $3
tomasooo29: folds
Uncalled bet ($3) returned to TbIP-TbIP 88
TbIP-TbIP 88 collected $5.88 from pot
TbIP-TbIP 88: doesn't show hand
*** SUMMARY ***
Total pot $6 | Rake $0.12
Board [Kd 5h As]
Seat 3: tomasooo29 (button) (small blind) folded on the Flop
Seat 4: TbIP-TbIP 88 (big blind) collected ($5.88)


PokerStars Hand #169295756137:  Hold'em Limit ($3/$6 USD) - 2017/04/20 4:52:29 ET
Table 'Titius' 6-max Seat #3 is the button
Seat 3: tomasooo29 ($161.47 in chips)
Seat 4: TbIP-TbIP 88 ($72 in chips)
tomasooo29: posts small blind $1
TbIP-TbIP 88: posts big blind $3
*** HOLE CARDS ***
tomasooo29: raises $3 to $6
TbIP-TbIP 88: calls $3
*** FLOP *** [5s Qh Qc]
TbIP-TbIP 88: bets $3
tomasooo29: raises $3 to $6
TbIP-TbIP 88: calls $3
*** TURN *** [5s Qh Qc] [3s]
TbIP-TbIP 88: checks
tomasooo29: bets $6
TbIP-TbIP 88: folds
Uncalled bet ($6) returned to tomasooo29
tomasooo29 collected $23.52 from pot
tomasooo29: doesn't show hand
*** SUMMARY ***
Total pot $24 | Rake $0.48
Board [5s Qh Qc 3s]
Seat 3: tomasooo29 (button) (small blind) collected ($23.52)
Seat 4: TbIP-TbIP 88 (big blind) folded on the Turn


PokerStars Hand #169295772402:  Hold'em Limit ($3/$6 USD) - 2017/04/20 4:53:15 ET
Table 'Titius' 6-max Seat #4 is the button
Seat 3: tomasooo29 ($172.99 in chips)
Seat 4: TbIP-TbIP 88 ($72 in chips)
TbIP-TbIP 88: posts small blind $1
tomasooo29: posts big blind $3
*** HOLE CARDS ***
TbIP-TbIP 88: raises $3 to $6
tomasooo29: calls $3
*** FLOP *** [4c Ad Kd]
tomasooo29: checks
TbIP-TbIP 88: bets $3
tomasooo29: folds
Uncalled bet ($3) returned to TbIP-TbIP 88
TbIP-TbIP 88 collected $11.76 from pot
TbIP-TbIP 88: doesn't show hand
*** SUMMARY ***
Total pot $12 | Rake $0.24
Board [4c Ad Kd]
Seat 3: tomasooo29 (big blind) folded on the Flop
Seat 4: TbIP-TbIP 88 (button) (small blind) collected ($11.76)


PokerStars Hand #169295802052:  Hold'em Limit ($3/$6 USD) - 2017/04/20 4:54:39 ET
Table 'Titius' 6-max Seat #4 is the button
Seat 3: tomasooo29 ($169.63 in chips)
Seat 4: TbIP-TbIP 88 ($74.64 in chips)
TbIP-TbIP 88: posts small blind $1
tomasooo29: posts big blind $3
*** HOLE CARDS ***
TbIP-TbIP 88: raises $3 to $6
tomasooo29: folds
Uncalled bet ($3) returned to TbIP-TbIP 88
TbIP-TbIP 88 collected $6 from pot
TbIP-TbIP 88: doesn't show hand
*** SUMMARY ***
Total pot $6 | Rake $0
Seat 3: tomasooo29 (big blind) folded before Flop
Seat 4: TbIP-TbIP 88 (button) (small blind) collected ($6)


PokerStars Hand #169295793928:  Hold'em Limit ($3/$6 USD) - 2017/04/20 4:54:16 ET
Table 'Titius' 6-max Seat #3 is the button
Seat 3: tomasooo29 ($160.99 in chips)
Seat 4: TbIP-TbIP 88 ($83.64 in chips)
tomasooo29: posts small blind $1
TbIP-TbIP 88: posts big blind $3
*** HOLE CARDS ***
tomasooo29: calls $2
TbIP-TbIP 88: raises $3 to $6
tomasooo29: calls $3
*** FLOP *** [Qh Qs 7c]
TbIP-TbIP 88: bets $3
tomasooo29: calls $3
*** TURN *** [Qh Qs 7c] [5h]
TbIP-TbIP 88: checks
tomasooo29: bets $6
TbIP-TbIP 88: folds
Uncalled bet ($6) returned to tomasooo29
tomasooo29 collected $17.64 from pot
tomasooo29: doesn't show hand
*** SUMMARY ***
Total pot $18 | Rake $0.36
Board [Qh Qs 7c 5h]
Seat 3: tomasooo29 (button) (small blind) collected ($17.64)
Seat 4: TbIP-TbIP 88 (big blind) folded on the Turn


PokerStars Hand #169295790392:  Hold'em Limit ($3/$6 USD) - 2017/04/20 4:54:06 ET
Table 'Titius' 6-max Seat #4 is the button
Seat 3: tomasooo29 ($163.99 in chips)
Seat 4: TbIP-TbIP 88 ($80.64 in chips)
TbIP-TbIP 88: posts small blind $1
tomasooo29: posts big blind $3
*** HOLE CARDS ***
TbIP-TbIP 88: raises $3 to $6
tomasooo29: folds
Uncalled bet ($3) returned to TbIP-TbIP 88
TbIP-TbIP 88 collected $6 from pot
TbIP-TbIP 88: doesn't show hand
*** SUMMARY ***
Total pot $6 | Rake $0
Seat 3: tomasooo29 (big blind) folded before Flop
Seat 4: TbIP-TbIP 88 (button) (small blind) collected ($6)


PokerStars Hand #169295805385:  Hold'em Limit ($3/$6 USD) - 2017/04/20 4:54:48 ET
Table 'Titius' 6-max Seat #3 is the button
Seat 3: tomasooo29 ($166.63 in chips)
Seat 4: TbIP-TbIP 88 ($77.64 in chips)
tomasooo29: posts small blind $1
TbIP-TbIP 88: posts big blind $3
*** HOLE CARDS ***
tomasooo29: calls $2
TbIP-TbIP 88: checks
*** FLOP *** [8d 9s 5h]
TbIP-TbIP 88: checks
tomasooo29: checks
*** TURN *** [8d 9s 5h] [Ac]
TbIP-TbIP 88: checks
tomasooo29: checks
*** RIVER *** [8d 9s 5h Ac] [7s]
TbIP-TbIP 88: checks
tomasooo29: bets $6
TbIP-TbIP 88: folds
Uncalled bet ($6) returned to tomasooo29
tomasooo29 collected $5.88 from pot
tomasooo29: doesn't show hand
*** SUMMARY ***
Total pot $6 | Rake $0.12
Board [8d 9s 5h Ac 7s]
Seat 3: tomasooo29 (button) (small blind) collected ($5.88)
Seat 4: TbIP-TbIP 88 (big blind) folded on the River


PokerStars Hand #169295816484:  Hold'em Limit ($3/$6 USD) - 2017/04/20 4:55:21 ET
Table 'Titius' 6-max Seat #4 is the button
Seat 3: tomasooo29 ($169.51 in chips)
Seat 4: TbIP-TbIP 88 ($74.64 in chips)
TbIP-TbIP 88: posts small blind $1
tomasooo29: posts big blind $3
*** HOLE CARDS ***
TbIP-TbIP 88: raises $3 to $6
tomasooo29: calls $3
*** FLOP *** [7s 9s Kh]
tomasooo29: checks
TbIP-TbIP 88: bets $3
tomasooo29: folds
Uncalled bet ($3) returned to TbIP-TbIP 88
TbIP-TbIP 88 collected $11.76 from pot
TbIP-TbIP 88: doesn't show hand
*** SUMMARY ***
Total pot $12 | Rake $0.24
Board [7s 9s Kh]
Seat 3: tomasooo29 (big blind) folded on the Flop
Seat 4: TbIP-TbIP 88 (button) (small blind) collected ($11.76)


PokerStars Hand #169295819985:  Hold'em Limit ($3/$6 USD) - 2017/04/20 4:55:32 ET
Table 'Titius' 6-max Seat #3 is the button
Seat 3: tomasooo29 ($163.51 in chips)
Seat 4: TbIP-TbIP 88 ($80.40 in chips)
tomasooo29: posts small blind $1
TbIP-TbIP 88: posts big blind $3
*** HOLE CARDS ***
tomasooo29: raises $3 to $6
TbIP-TbIP 88: raises $3 to $9
tomasooo29: calls $3
*** FLOP *** [Kc 9c 3c]
TbIP-TbIP 88: bets $3
tomasooo29: calls $3
*** TURN *** [Kc 9c 3c] [Ac]
TbIP-TbIP 88: checks
tomasooo29: bets $6
TbIP-TbIP 88: calls $6
*** RIVER *** [Kc 9c 3c Ac] [Qc]
TbIP-TbIP 88: checks
tomasooo29: bets $6
TbIP-TbIP 88: calls $6
*** SHOW DOWN ***
tomasooo29: shows [2c 2d] (a flush, Ace high)
TbIP-TbIP 88: shows [Ah Kd] (a flush, Ace high)
TbIP-TbIP 88 collected $23.75 from pot
tomasooo29 collected $23.75 from pot
*** SUMMARY ***
Total pot $48 | Rake $0.50
Board [Kc 9c 3c Ac Qc]
Seat 3: tomasooo29 (button) (small blind) showed [2c 2d] and won ($23.75) with a flush, Ace high
Seat 4: TbIP-TbIP 88 (big blind) showed [Ah Kd] and won ($23.75) with a flush, Ace high


PokerStars Hand #169295847656:  Hold'em Limit ($3/$6 USD) - 2017/04/20 4:56:57 ET
Table 'Titius' 6-max Seat #4 is the button
Seat 3: tomasooo29 ($157.01 in chips)
Seat 4: TbIP-TbIP 88 ($85.66 in chips)
TbIP-TbIP 88: posts small blind $1
tomasooo29: posts big blind $3
*** HOLE CARDS ***
TbIP-TbIP 88: folds
Uncalled bet ($2) returned to tomasooo29
tomasooo29 collected $2 from pot
tomasooo29: doesn't show hand
*** SUMMARY ***
Total pot $2 | Rake $0
Seat 3: tomasooo29 (big blind) collected ($2)
Seat 4: TbIP-TbIP 88 (button) (small blind) folded before Flop


PokerStars Hand #169295843624:  Hold'em Limit ($3/$6 USD) - 2017/04/20 4:56:45 ET
Table 'Titius' 6-max Seat #3 is the button
Seat 3: tomasooo29 ($163.01 in chips)
Seat 4: TbIP-TbIP 88 ($79.90 in chips)
tomasooo29: posts small blind $1
TbIP-TbIP 88: posts big blind $3
*** HOLE CARDS ***
tomasooo29: calls $2
TbIP-TbIP 88: raises $3 to $6
tomasooo29: calls $3
*** FLOP *** [7d Js 2d]
TbIP-TbIP 88: bets $3
tomasooo29: folds
Uncalled bet ($3) returned to TbIP-TbIP 88
TbIP-TbIP 88 collected $11.76 from pot
TbIP-TbIP 88: doesn't show hand
*** SUMMARY ***
Total pot $12 | Rake $0.24
Board [7d Js 2d]
Seat 3: tomasooo29 (button) (small blind) folded on the Flop
Seat 4: TbIP-TbIP 88 (big blind) collected ($11.76)


PokerStars Hand #169295833862:  Hold'em Limit ($3/$6 USD) - 2017/04/20 4:56:14 ET
Table 'Titius' 6-max Seat #4 is the button
Seat 3: tomasooo29 ($163.26 in chips)
Seat 4: TbIP-TbIP 88 ($80.15 in chips)
TbIP-TbIP 88: posts small blind $1
tomasooo29: posts big blind $3
*** HOLE CARDS ***
TbIP-TbIP 88: raises $3 to $6
tomasooo29: calls $3
*** FLOP *** [Qc 5d Kh]
tomasooo29: checks
TbIP-TbIP 88: bets $3
tomasooo29: calls $3
*** TURN *** [Qc 5d Kh] [4s]
tomasooo29: checks
TbIP-TbIP 88: bets $6
tomasooo29: calls $6
*** RIVER *** [Qc 5d Kh 4s] [5s]
tomasooo29: bets $6
TbIP-TbIP 88: calls $6
*** SHOW DOWN ***
tomasooo29: shows [8d Qh] (two pair, Queens and Fives)
TbIP-TbIP 88: shows [Qd 2h] (two pair, Queens and Fives)
tomasooo29 collected $20.75 from pot
TbIP-TbIP 88 collected $20.75 from pot
*** SUMMARY ***
Total pot $42 | Rake $0.50
Board [Qc 5d Kh 4s 5s]
Seat 3: tomasooo29 (big blind) showed [8d Qh] and won ($20.75) with two pair, Queens and Fives
Seat 4: TbIP-TbIP 88 (button) (small blind) showed [Qd 2h] and won ($20.75) with two pair, Queens and Fives


PokerStars Hand #169295849679:  Hold'em Limit ($3/$6 USD) - 2017/04/20 4:57:03 ET
Table 'Titius' 6-max Seat #3 is the button
Seat 3: tomasooo29 ($158.01 in chips)
Seat 4: TbIP-TbIP 88 ($84.66 in chips)
tomasooo29: posts small blind $1
TbIP-TbIP 88: posts big blind $3
*** HOLE CARDS ***
tomasooo29: calls $2
TbIP-TbIP 88: checks
*** FLOP *** [5d 4d 3s]
TbIP-TbIP 88: bets $3
tomasooo29: calls $3
*** TURN *** [5d 4d 3s] [Js]
TbIP-TbIP 88: bets $6
tomasooo29: raises $6 to $12
TbIP-TbIP 88: calls $6
*** RIVER *** [5d 4d 3s Js] [6d]
TbIP-TbIP 88: bets $6
tomasooo29: raises $6 to $12
TbIP-TbIP 88: folds
Uncalled bet ($6) returned to tomasooo29
tomasooo29 collected $47.50 from pot
tomasooo29: doesn't show hand
*** SUMMARY ***
Total pot $48 | Rake $0.50
Board [5d 4d 3s Js 6d]
Seat 3: tomasooo29 (button) (small blind) collected ($47.50)
Seat 4: TbIP-TbIP 88 (big blind) folded on the River


PokerStars Hand #169295875779:  Hold'em Limit ($3/$6 USD) - 2017/04/20 4:58:23 ET
Table 'Titius' 6-max Seat #3 is the button
Seat 3: tomasooo29 ($187.27 in chips)
Seat 4: TbIP-TbIP 88 ($72 in chips)
tomasooo29: posts small blind $1
TbIP-TbIP 88: posts big blind $3
*** HOLE CARDS ***
tomasooo29: calls $2
TbIP-TbIP 88: checks
*** FLOP *** [8c 7d Kh]
TbIP-TbIP 88: bets $3
tomasooo29: calls $3
*** TURN *** [8c 7d Kh] [2s]
TbIP-TbIP 88: checks
tomasooo29: checks
*** RIVER *** [8c 7d Kh 2s] [Jd]
TbIP-TbIP 88: checks
tomasooo29: bets $6
TbIP-TbIP 88: folds
Uncalled bet ($6) returned to tomasooo29
tomasooo29 collected $11.76 from pot
tomasooo29: doesn't show hand
*** SUMMARY ***
Total pot $12 | Rake $0.24
Board [8c 7d Kh 2s Jd]
Seat 3: tomasooo29 (button) (small blind) collected ($11.76)
Seat 4: TbIP-TbIP 88 (big blind) folded on the River


PokerStars Hand #169295866183:  Hold'em Limit ($3/$6 USD) - 2017/04/20 4:57:54 ET
Table 'Titius' 6-max Seat #4 is the button
Seat 3: tomasooo29 ($181.51 in chips)
Seat 4: TbIP-TbIP 88 ($72 in chips)
TbIP-TbIP 88: posts small blind $1
tomasooo29: posts big blind $3
*** HOLE CARDS ***
TbIP-TbIP 88: raises $3 to $6
tomasooo29: calls $3
*** FLOP *** [8s 9h 6h]
tomasooo29: bets $3
TbIP-TbIP 88: folds
Uncalled bet ($3) returned to tomasooo29
tomasooo29 collected $11.76 from pot
tomasooo29: doesn't show hand
*** SUMMARY ***
Total pot $12 | Rake $0.24
Board [8s 9h 6h]
Seat 3: tomasooo29 (big blind) collected ($11.76)
Seat 4: TbIP-TbIP 88 (button) (small blind) folded on the Flop


PokerStars Hand #169295891086:  Hold'em Limit ($3/$6 USD) - 2017/04/20 4:59:10 ET
Table 'Titius' 6-max Seat #4 is the button
Seat 3: tomasooo29 ($193.03 in chips)
Seat 4: TbIP-TbIP 88 ($72 in chips)
TbIP-TbIP 88: posts small blind $1
tomasooo29: posts big blind $3
*** HOLE CARDS ***
TbIP-TbIP 88: folds
Uncalled bet ($2) returned to tomasooo29
tomasooo29 collected $2 from pot
tomasooo29: doesn't show hand
*** SUMMARY ***
Total pot $2 | Rake $0
Seat 3: tomasooo29 (big blind) collected ($2)
Seat 4: TbIP-TbIP 88 (button) (small blind) folded before Flop


PokerStars Hand #169295894087:  Hold'em Limit ($3/$6 USD) - 2017/04/20 4:59:19 ET
Table 'Titius' 6-max Seat #3 is the button
Seat 3: tomasooo29 ($194.03 in chips)
Seat 4: TbIP-TbIP 88 ($72 in chips)
tomasooo29: posts small blind $1
TbIP-TbIP 88: posts big blind $3
*** HOLE CARDS ***
tomasooo29: calls $2
TbIP-TbIP 88: raises $3 to $6
tomasooo29: calls $3
*** FLOP *** [6s 4h 4d]
TbIP-TbIP 88: bets $3
tomasooo29: calls $3
*** TURN *** [6s 4h 4d] [4s]
TbIP-TbIP 88: checks
tomasooo29: bets $6
TbIP-TbIP 88: calls $6
*** RIVER *** [6s 4h 4d 4s] [Js]
TbIP-TbIP 88: checks
tomasooo29: bets $6
TbIP-TbIP 88: calls $6
*** SHOW DOWN ***
tomasooo29: shows [7h 7c] (a full house, Fours full of Sevens)
TbIP-TbIP 88: mucks hand
tomasooo29 collected $41.50 from pot
*** SUMMARY ***
Total pot $42 | Rake $0.50
Board [6s 4h 4d 4s Js]
Seat 3: tomasooo29 (button) (small blind) showed [7h 7c] and won ($41.50) with a full house, Fours full of Sevens
Seat 4: TbIP-TbIP 88 (big blind) mucked


PokerStars Hand #169295918857:  Hold'em Limit ($3/$6 USD) - 2017/04/20 5:00:34 ET
Table 'Titius' 6-max Seat #4 is the button
Seat 3: tomasooo29 ($196.53 in chips)
Seat 4: TbIP-TbIP 88 ($89.50 in chips)
TbIP-TbIP 88: posts small blind $1
tomasooo29: posts big blind $3
*** HOLE CARDS ***
TbIP-TbIP 88: raises $3 to $6
tomasooo29: calls $3
*** FLOP *** [Qc 2s Js]
tomasooo29: bets $3
TbIP-TbIP 88: calls $3
*** TURN *** [Qc 2s Js] [4h]
tomasooo29: bets $6
TbIP-TbIP 88: calls $6
*** RIVER *** [Qc 2s Js 4h] [7c]
tomasooo29: checks
TbIP-TbIP 88: bets $6
tomasooo29: folds
Uncalled bet ($6) returned to TbIP-TbIP 88
TbIP-TbIP 88 collected $29.50 from pot
TbIP-TbIP 88: doesn't show hand
*** SUMMARY ***
Total pot $30 | Rake $0.50
Board [Qc 2s Js 4h 7c]
Seat 3: tomasooo29 (big blind) folded on the River
Seat 4: TbIP-TbIP 88 (button) (small blind) collected ($29.50)


PokerStars Hand #169295914350:  Hold'em Limit ($3/$6 USD) - 2017/04/20 5:00:20 ET
Table 'Titius' 6-max Seat #3 is the button
Seat 3: tomasooo29 ($193.53 in chips)
Seat 4: TbIP-TbIP 88 ($92.50 in chips)
tomasooo29: posts small blind $1
TbIP-TbIP 88: posts big blind $3
*** HOLE CARDS ***
tomasooo29: raises $3 to $6
TbIP-TbIP 88: folds
Uncalled bet ($3) returned to tomasooo29
tomasooo29 collected $6 from pot
tomasooo29: doesn't show hand
*** SUMMARY ***
Total pot $6 | Rake $0
Seat 3: tomasooo29 (button) (small blind) collected ($6)
Seat 4: TbIP-TbIP 88 (big blind) folded before Flop


PokerStars Hand #169295904417:  Hold'em Limit ($3/$6 USD) - 2017/04/20 4:59:51 ET
Table 'Titius' 6-max Seat #4 is the button
Seat 3: tomasooo29 ($214.53 in chips)
Seat 4: TbIP-TbIP 88 ($72 in chips)
TbIP-TbIP 88: posts small blind $1
tomasooo29: posts big blind $3
*** HOLE CARDS ***
TbIP-TbIP 88: raises $3 to $6
tomasooo29: calls $3
*** FLOP *** [2h 5c Qh]
tomasooo29: checks
TbIP-TbIP 88: bets $3
tomasooo29: calls $3
*** TURN *** [2h 5c Qh] [Ac]
tomasooo29: checks
TbIP-TbIP 88: checks
*** RIVER *** [2h 5c Qh Ac] [Tc]
tomasooo29: bets $6
TbIP-TbIP 88: raises $6 to $12
tomasooo29: calls $6
*** SHOW DOWN ***
TbIP-TbIP 88: shows [Ts 5d] (two pair, Tens and Fives)
tomasooo29: mucks hand
TbIP-TbIP 88 collected $41.50 from pot
*** SUMMARY ***
Total pot $42 | Rake $0.50
Board [2h 5c Qh Ac Tc]
Seat 3: tomasooo29 (big blind) mucked
Seat 4: TbIP-TbIP 88 (button) (small blind) showed [Ts 5d] and won ($41.50) with two pair, Tens and Fives


PokerStars Hand #169295947509:  Hold'em Limit ($3/$6 USD) - 2017/04/20 5:01:55 ET
Table 'Titius' 6-max Seat #4 is the button
Seat 3: tomasooo29 ($197.81 in chips)
Seat 4: TbIP-TbIP 88 ($87 in chips)
TbIP-TbIP 88: posts small blind $1
tomasooo29: posts big blind $3
*** HOLE CARDS ***
TbIP-TbIP 88: raises $3 to $6
tomasooo29: calls $3
*** FLOP *** [6s 3d 8c]
tomasooo29: bets $3
TbIP-TbIP 88: calls $3
*** TURN *** [6s 3d 8c] [As]
tomasooo29: bets $6
TbIP-TbIP 88: calls $6
*** RIVER *** [6s 3d 8c As] [Kc]
tomasooo29: bets $6
TbIP-TbIP 88: calls $6
*** SHOW DOWN ***
tomasooo29: shows [8s 5c] (a pair of Eights)
TbIP-TbIP 88: shows [8h 7c] (a pair of Eights - Ace+King+Seven kicker)
TbIP-TbIP 88 collected $41.50 from pot
*** SUMMARY ***
Total pot $42 | Rake $0.50
Board [6s 3d 8c As Kc]
Seat 3: tomasooo29 (big blind) showed [8s 5c] and lost with a pair of Eights
Seat 4: TbIP-TbIP 88 (button) (small blind) showed [8h 7c] and won ($41.50) with a pair of Eights


PokerStars Hand #169295945514:  Hold'em Limit ($3/$6 USD) - 2017/04/20 5:01:49 ET
Table 'Titius' 6-max Seat #3 is the button
Seat 3: tomasooo29 ($198.81 in chips)
Seat 4: TbIP-TbIP 88 ($86 in chips)
tomasooo29: posts small blind $1
TbIP-TbIP 88: posts big blind $3
*** HOLE CARDS ***
tomasooo29: folds
Uncalled bet ($2) returned to TbIP-TbIP 88
TbIP-TbIP 88 collected $2 from pot
TbIP-TbIP 88: doesn't show hand
*** SUMMARY ***
Total pot $2 | Rake $0
Seat 3: tomasooo29 (button) (small blind) folded before Flop
Seat 4: TbIP-TbIP 88 (big blind) collected ($2)


PokerStars Hand #169295937492:  Hold'em Limit ($3/$6 USD) - 2017/04/20 5:01:27 ET
Table 'Titius' 6-max Seat #4 is the button
Seat 3: tomasooo29 ($187.29 in chips)
Seat 4: TbIP-TbIP 88 ($98 in chips)
TbIP-TbIP 88: posts small blind $1
tomasooo29: posts big blind $3
*** HOLE CARDS ***
TbIP-TbIP 88: raises $3 to $6
tomasooo29: raises $3 to $9
TbIP-TbIP 88: calls $3
*** FLOP *** [2d Ks As]
tomasooo29: bets $3
TbIP-TbIP 88: calls $3
*** TURN *** [2d Ks As] [Ah]
tomasooo29: checks
TbIP-TbIP 88: checks
*** RIVER *** [2d Ks As Ah] [6c]
tomasooo29: bets $6
TbIP-TbIP 88: folds
Uncalled bet ($6) returned to tomasooo29
tomasooo29 collected $23.52 from pot
tomasooo29: doesn't show hand
*** SUMMARY ***
Total pot $24 | Rake $0.48
Board [2d Ks As Ah 6c]
Seat 3: tomasooo29 (big blind) collected ($23.52)
Seat 4: TbIP-TbIP 88 (button) (small blind) folded on the River


PokerStars Hand #169295928068:  Hold'em Limit ($3/$6 USD) - 2017/04/20 5:01:00 ET
Table 'Titius' 6-max Seat #3 is the button
Seat 3: tomasooo29 ($181.53 in chips)
Seat 4: TbIP-TbIP 88 ($104 in chips)
tomasooo29: posts small blind $1
TbIP-TbIP 88: posts big blind $3
*** HOLE CARDS ***
tomasooo29: raises $3 to $6
TbIP-TbIP 88: calls $3
*** FLOP *** [Kd Td Js]
TbIP-TbIP 88: checks
tomasooo29: checks
*** TURN *** [Kd Td Js] [7s]
TbIP-TbIP 88: checks
tomasooo29: checks
*** RIVER *** [Kd Td Js 7s] [7h]
TbIP-TbIP 88: checks
tomasooo29: bets $6
TbIP-TbIP 88: folds
Uncalled bet ($6) returned to tomasooo29
tomasooo29 collected $11.76 from pot
tomasooo29: doesn't show hand
*** SUMMARY ***
Total pot $12 | Rake $0.24
Board [Kd Td Js 7s 7h]
Seat 3: tomasooo29 (button) (small blind) collected ($11.76)
Seat 4: TbIP-TbIP 88 (big blind) folded on the River


PokerStars Hand #169295972486:  Hold'em Limit ($3/$6 USD) - 2017/04/20 5:03:04 ET
Table 'Titius' 6-max Seat #4 is the button
Seat 3: tomasooo29 ($194.31 in chips)
Seat 4: TbIP-TbIP 88 ($89 in chips)
TbIP-TbIP 88: posts small blind $1
tomasooo29: posts big blind $3
*** HOLE CARDS ***
TbIP-TbIP 88: raises $3 to $6
tomasooo29: folds
Uncalled bet ($3) returned to TbIP-TbIP 88
TbIP-TbIP 88 collected $6 from pot
TbIP-TbIP 88: doesn't show hand
*** SUMMARY ***
Total pot $6 | Rake $0
Seat 3: tomasooo29 (big blind) folded before Flop
Seat 4: TbIP-TbIP 88 (button) (small blind) collected ($6)


PokerStars Hand #169295953895:  Hold'em Limit ($3/$6 USD) - 2017/04/20 5:02:13 ET
Table 'Titius' 6-max Seat #3 is the button
Seat 3: tomasooo29 ($176.81 in chips)
Seat 4: TbIP-TbIP 88 ($107.50 in chips)
tomasooo29: posts small blind $1
TbIP-TbIP 88: posts big blind $3
*** HOLE CARDS ***
tomasooo29: raises $3 to $6
TbIP-TbIP 88: calls $3
*** FLOP *** [5s 8c 7c]
TbIP-TbIP 88: bets $3
tomasooo29: raises $3 to $6
TbIP-TbIP 88: calls $3
*** TURN *** [5s 8c 7c] [2c]
TbIP-TbIP 88: checks
tomasooo29: bets $6
TbIP-TbIP 88: calls $6
*** RIVER *** [5s 8c 7c 2c] [7d]
TbIP-TbIP 88: bets $6
tomasooo29: raises $6 to $12
TbIP-TbIP 88: calls $6
*** SHOW DOWN ***
tomasooo29: shows [8d 8h] (a full house, Eights full of Sevens)
TbIP-TbIP 88: mucks hand
tomasooo29 collected $59.50 from pot
*** SUMMARY ***
Total pot $60 | Rake $0.50
Board [5s 8c 7c 2c 7d]
Seat 3: tomasooo29 (button) (small blind) showed [8d 8h] and won ($59.50) with a full house, Eights full of Sevens
Seat 4: TbIP-TbIP 88 (big blind) mucked


PokerStars Hand #169295969586:  Hold'em Limit ($3/$6 USD) - 2017/04/20 5:02:57 ET
Table 'Titius' 6-max Seat #3 is the button
Seat 3: tomasooo29 ($191.31 in chips)
Seat 4: TbIP-TbIP 88 ($92 in chips)
tomasooo29: posts small blind $1
TbIP-TbIP 88: posts big blind $3
*** HOLE CARDS ***
tomasooo29: raises $3 to $6
TbIP-TbIP 88: folds
Uncalled bet ($3) returned to tomasooo29
tomasooo29 collected $6 from pot
tomasooo29: doesn't show hand
*** SUMMARY ***
Total pot $6 | Rake $0
Seat 3: tomasooo29 (button) (small blind) collected ($6)
Seat 4: TbIP-TbIP 88 (big blind) folded before Flop


PokerStars Hand #169295962903:  Hold'em Limit ($3/$6 USD) - 2017/04/20 5:02:38 ET
Table 'Titius' 6-max Seat #4 is the button
Seat 3: tomasooo29 ($206.31 in chips)
Seat 4: TbIP-TbIP 88 ($77.50 in chips)
TbIP-TbIP 88: posts small blind $1
tomasooo29: posts big blind $3
*** HOLE CARDS ***
TbIP-TbIP 88: raises $3 to $6
tomasooo29: calls $3
*** FLOP *** [4h Ah 2d]
tomasooo29: checks
TbIP-TbIP 88: bets $3
tomasooo29: calls $3
*** TURN *** [4h Ah 2d] [Jc]
tomasooo29: checks
TbIP-TbIP 88: checks
*** RIVER *** [4h Ah 2d Jc] [Js]
tomasooo29: bets $6
TbIP-TbIP 88: calls $6
*** SHOW DOWN ***
tomasooo29: shows [6d 3c] (a pair of Jacks)
TbIP-TbIP 88: shows [4c 5c] (two pair, Jacks and Fours)
TbIP-TbIP 88 collected $29.50 from pot
*** SUMMARY ***
Total pot $30 | Rake $0.50
Board [4h Ah 2d Jc Js]
Seat 3: tomasooo29 (big blind) showed [6d 3c] and lost with a pair of Jacks
Seat 4: TbIP-TbIP 88 (button) (small blind) showed [4c 5c] and won ($29.50) with two pair, Jacks and Fours


PokerStars Hand #169295974561:  Hold'em Limit ($3/$6 USD) - 2017/04/20 5:03:10 ET
Table 'Titius' 6-max Seat #3 is the button
Seat 3: tomasooo29 ($191.31 in chips)
Seat 4: TbIP-TbIP 88 ($92 in chips)
tomasooo29: posts small blind $1
TbIP-TbIP 88: posts big blind $3
*** HOLE CARDS ***
tomasooo29: raises $3 to $6
TbIP-TbIP 88: raises $3 to $9
tomasooo29: raises $3 to $12
Betting is capped
TbIP-TbIP 88: calls $3
*** FLOP *** [Jh 7h 6c]
TbIP-TbIP 88: checks
tomasooo29: bets $3
TbIP-TbIP 88: calls $3
*** TURN *** [Jh 7h 6c] [6h]
TbIP-TbIP 88: checks
tomasooo29: bets $6
TbIP-TbIP 88: calls $6
*** RIVER *** [Jh 7h 6c 6h] [Tc]
TbIP-TbIP 88: checks
tomasooo29: bets $6
TbIP-TbIP 88: calls $6
*** SHOW DOWN ***
tomasooo29: shows [Kh Qh] (a flush, King high)
TbIP-TbIP 88: mucks hand
tomasooo29 collected $53.50 from pot
*** SUMMARY ***
Total pot $54 | Rake $0.50
Board [Jh 7h 6c 6h Tc]
Seat 3: tomasooo29 (button) (small blind) showed [Kh Qh] and won ($53.50) with a flush, King high
Seat 4: TbIP-TbIP 88 (big blind) mucked


PokerStars Hand #169295987326:  Hold'em Limit ($3/$6 USD) - 2017/04/20 5:03:45 ET
Table 'Titius' 6-max Seat #3 is the button
Seat 3: tomasooo29 ($223.57 in chips)
Seat 4: TbIP-TbIP 88 ($72 in chips)
tomasooo29: posts small blind $1
TbIP-TbIP 88: posts big blind $3
*** HOLE CARDS ***
tomasooo29: folds
Uncalled bet ($2) returned to TbIP-TbIP 88
TbIP-TbIP 88 collected $2 from pot
TbIP-TbIP 88: doesn't show hand
*** SUMMARY ***
Total pot $2 | Rake $0
Seat 3: tomasooo29 (button) (small blind) folded before Flop
Seat 4: TbIP-TbIP 88 (big blind) collected ($2)


PokerStars Hand #169295983336:  Hold'em Limit ($3/$6 USD) - 2017/04/20 5:03:34 ET
Table 'Titius' 6-max Seat #4 is the button
Seat 3: tomasooo29 ($217.81 in chips)
Seat 4: TbIP-TbIP 88 ($72 in chips)
TbIP-TbIP 88: posts small blind $1
tomasooo29: posts big blind $3
*** HOLE CARDS ***
TbIP-TbIP 88: raises $3 to $6
tomasooo29: calls $3
*** FLOP *** [Jc 8d Qh]
tomasooo29: bets $3
TbIP-TbIP 88: folds
Uncalled bet ($3) returned to tomasooo29
tomasooo29 collected $11.76 from pot
tomasooo29: doesn't show hand
*** SUMMARY ***
Total pot $12 | Rake $0.24
Board [Jc 8d Qh]
Seat 3: tomasooo29 (big blind) collected ($11.76)
Seat 4: TbIP-TbIP 88 (button) (small blind) folded on the Flop


PokerStars Hand #169295989081:  Hold'em Limit ($3/$6 USD) - 2017/04/20 5:03:50 ET
Table 'Titius' 6-max Seat #4 is the button
Seat 3: tomasooo29 ($222.57 in chips)
Seat 4: TbIP-TbIP 88 ($73 in chips)
TbIP-TbIP 88: posts small blind $1
tomasooo29: posts big blind $3
*** HOLE CARDS ***
TbIP-TbIP 88: raises $3 to $6
tomasooo29: calls $3
*** FLOP *** [2h 8s As]
tomasooo29: checks
TbIP-TbIP 88: bets $3
tomasooo29: folds
Uncalled bet ($3) returned to TbIP-TbIP 88
TbIP-TbIP 88 collected $11.76 from pot
TbIP-TbIP 88: doesn't show hand
*** SUMMARY ***
Total pot $12 | Rake $0.24
Board [2h 8s As]
Seat 3: tomasooo29 (big blind) folded on the Flop
Seat 4: TbIP-TbIP 88 (button) (small blind) collected ($11.76)


PokerStars Hand #169296008885:  Hold'em Limit ($3/$6 USD) - 2017/04/20 5:04:44 ET
Table 'Titius' 6-max Seat #3 is the button
Seat 3: tomasooo29 ($183.21 in chips)
Seat 4: TbIP-TbIP 88 ($111.26 in chips)
tomasooo29: posts small blind $1
TbIP-TbIP 88: posts big blind $3
*** HOLE CARDS ***
tomasooo29: raises $3 to $6
TbIP-TbIP 88: calls $3
*** FLOP *** [4s As 2h]
TbIP-TbIP 88: checks
tomasooo29: checks
*** TURN *** [4s As 2h] [Qh]
TbIP-TbIP 88: checks
tomasooo29: checks
*** RIVER *** [4s As 2h Qh] [Js]
TbIP-TbIP 88: checks
tomasooo29: bets $6
TbIP-TbIP 88: folds
Uncalled bet ($6) returned to tomasooo29
tomasooo29 collected $11.76 from pot
tomasooo29: doesn't show hand
*** SUMMARY ***
Total pot $12 | Rake $0.24
Board [4s As 2h Qh Js]
Seat 3: tomasooo29 (button) (small blind) collected ($11.76)
Seat 4: TbIP-TbIP 88 (big blind) folded on the River


PokerStars Hand #169295992705:  Hold'em Limit ($3/$6 USD) - 2017/04/20 5:04:00 ET
Table 'Titius' 6-max Seat #3 is the button
Seat 3: tomasooo29 ($216.57 in chips)
Seat 4: TbIP-TbIP 88 ($78.76 in chips)
tomasooo29: posts small blind $1
TbIP-TbIP 88: posts big blind $3
*** HOLE CARDS ***
tomasooo29: raises $3 to $6
TbIP-TbIP 88: raises $3 to $9
tomasooo29: calls $3
*** FLOP *** [2d 7s Jh]
TbIP-TbIP 88: bets $3
tomasooo29: calls $3
*** TURN *** [2d 7s Jh] [6d]
TbIP-TbIP 88: bets $6
tomasooo29: raises $6 to $12
TbIP-TbIP 88: calls $6
*** RIVER *** [2d 7s Jh 6d] [Jd]
TbIP-TbIP 88: checks
tomasooo29: bets $6
TbIP-TbIP 88: raises $6 to $12
tomasooo29: raises $6 to $18
TbIP-TbIP 88: calls $6
*** SHOW DOWN ***
tomasooo29: shows [8s Js] (three of a kind, Jacks)
TbIP-TbIP 88: shows [Ad 8d] (a flush, Ace high)
TbIP-TbIP 88 collected $83.50 from pot
*** SUMMARY ***
Total pot $84 | Rake $0.50
Board [2d 7s Jh 6d Jd]
Seat 3: tomasooo29 (button) (small blind) showed [8s Js] and lost with three of a kind, Jacks
Seat 4: TbIP-TbIP 88 (big blind) showed [Ad 8d] and won ($83.50) with a flush, Ace high


PokerStars Hand #169296004441:  Hold'em Limit ($3/$6 USD) - 2017/04/20 5:04:32 ET
Table 'Titius' 6-max Seat #4 is the button
Seat 3: tomasooo29 ($174.57 in chips)
Seat 4: TbIP-TbIP 88 ($120.26 in chips)
TbIP-TbIP 88: posts small blind $1
tomasooo29: posts big blind $3
*** HOLE CARDS ***
TbIP-TbIP 88: raises $3 to $6
tomasooo29: raises $3 to $9
TbIP-TbIP 88: calls $3
*** FLOP *** [7s Ac 7c]
tomasooo29: bets $3
TbIP-TbIP 88: folds
Uncalled bet ($3) returned to tomasooo29
tomasooo29 collected $17.64 from pot
tomasooo29: doesn't show hand
*** SUMMARY ***
Total pot $18 | Rake $0.36
Board [7s Ac 7c]
Seat 3: tomasooo29 (big blind) collected ($17.64)
Seat 4: TbIP-TbIP 88 (button) (small blind) folded on the Flop


PokerStars Hand #169296033058:  Hold'em Limit ($3/$6 USD) - 2017/04/20 5:05:47 ET
Table 'Titius' 6-max Seat #4 is the button
Seat 3: tomasooo29 ($158.97 in chips)
Seat 4: TbIP-TbIP 88 ($134.40 in chips)
TbIP-TbIP 88: posts small blind $1
tomasooo29: posts big blind $3
*** HOLE CARDS ***
TbIP-TbIP 88: raises $3 to $6
tomasooo29: raises $3 to $9
TbIP-TbIP 88: raises $3 to $12
Betting is capped
tomasooo29: calls $3
*** FLOP *** [8d 9s 2s]
tomasooo29: bets $3
TbIP-TbIP 88: calls $3
*** TURN *** [8d 9s 2s] [Kc]
tomasooo29: bets $6
TbIP-TbIP 88: raises $6 to $12
tomasooo29: calls $6
*** RIVER *** [8d 9s 2s Kc] [9c]
tomasooo29: bets $6
TbIP-TbIP 88: raises $6 to $12
tomasooo29: calls $6
*** SHOW DOWN ***
TbIP-TbIP 88: shows [Ad As] (two pair, Aces and Nines)
tomasooo29: mucks hand
TbIP-TbIP 88 collected $77.50 from pot
*** SUMMARY ***
Total pot $78 | Rake $0.50
Board [8d 9s 2s Kc 9c]
Seat 3: tomasooo29 (big blind) mucked
Seat 4: TbIP-TbIP 88 (button) (small blind) showed [Ad As] and won ($77.50) with two pair, Aces and Nines


PokerStars Hand #169296028052:  Hold'em Limit ($3/$6 USD) - 2017/04/20 5:05:34 ET
Table 'Titius' 6-max Seat #3 is the button
Seat 3: tomasooo29 ($167.97 in chips)
Seat 4: TbIP-TbIP 88 ($125.76 in chips)
tomasooo29: posts small blind $1
TbIP-TbIP 88: posts big blind $3
*** HOLE CARDS ***
tomasooo29: raises $3 to $6
TbIP-TbIP 88: calls $3
*** FLOP *** [6h Jh 3c]
TbIP-TbIP 88: bets $3
tomasooo29: calls $3
*** TURN *** [6h Jh 3c] [2c]
TbIP-TbIP 88: bets $6
tomasooo29: folds
Uncalled bet ($6) returned to TbIP-TbIP 88
TbIP-TbIP 88 collected $17.64 from pot
TbIP-TbIP 88: doesn't show hand
*** SUMMARY ***
Total pot $18 | Rake $0.36
Board [6h Jh 3c 2c]
Seat 3: tomasooo29 (button) (small blind) folded on the Turn
Seat 4: TbIP-TbIP 88 (big blind) collected ($17.64)


PokerStars Hand #169296019707:  Hold'em Limit ($3/$6 USD) - 2017/04/20 5:05:12 ET
Table 'Titius' 6-max Seat #4 is the button
Seat 3: tomasooo29 ($188.97 in chips)
Seat 4: TbIP-TbIP 88 ($105.26 in chips)
TbIP-TbIP 88: posts small blind $1
tomasooo29: posts big blind $3
*** HOLE CARDS ***
TbIP-TbIP 88: raises $3 to $6
tomasooo29: calls $3
*** FLOP *** [Qh 4h Th]
tomasooo29: bets $3
TbIP-TbIP 88: calls $3
*** TURN *** [Qh 4h Th] [2s]
tomasooo29: bets $6
TbIP-TbIP 88: calls $6
*** RIVER *** [Qh 4h Th 2s] [Ah]
tomasooo29: bets $6
TbIP-TbIP 88: calls $6
*** SHOW DOWN ***
tomasooo29: shows [4d Kc] (a pair of Fours)
TbIP-TbIP 88: shows [5c Qs] (a pair of Queens)
TbIP-TbIP 88 collected $41.50 from pot
*** SUMMARY ***
Total pot $42 | Rake $0.50
Board [Qh 4h Th 2s Ah]
Seat 3: tomasooo29 (big blind) showed [4d Kc] and lost with a pair of Fours
Seat 4: TbIP-TbIP 88 (button) (small blind) showed [5c Qs] and won ($41.50) with a pair of Queens


PokerStars Hand #169296043025:  Hold'em Limit ($3/$6 USD) - 2017/04/20 5:06:13 ET
Table 'Titius' 6-max Seat #3 is the button
Seat 3: tomasooo29 ($119.97 in chips)
Seat 4: TbIP-TbIP 88 ($172.90 in chips)
tomasooo29: posts small blind $1
TbIP-TbIP 88: posts big blind $3
*** HOLE CARDS ***
tomasooo29: raises $3 to $6
TbIP-TbIP 88: calls $3
*** FLOP *** [Ac 3d 6d]
TbIP-TbIP 88: checks
tomasooo29: checks
*** TURN *** [Ac 3d 6d] [8d]
TbIP-TbIP 88: checks
tomasooo29: checks
*** RIVER *** [Ac 3d 6d 8d] [Qc]
TbIP-TbIP 88: bets $6
tomasooo29: folds
Uncalled bet ($6) returned to TbIP-TbIP 88
TbIP-TbIP 88 collected $11.76 from pot
TbIP-TbIP 88: doesn't show hand
*** SUMMARY ***
Total pot $12 | Rake $0.24
Board [Ac 3d 6d 8d Qc]
Seat 3: tomasooo29 (button) (small blind) folded on the River
Seat 4: TbIP-TbIP 88 (big blind) collected ($11.76)


PokerStars Hand #169296051244:  Hold'em Limit ($3/$6 USD) - 2017/04/20 5:06:35 ET
Table 'Titius' 6-max Seat #4 is the button
Seat 3: tomasooo29 ($113.97 in chips)
Seat 4: TbIP-TbIP 88 ($178.66 in chips)
TbIP-TbIP 88: posts small blind $1
tomasooo29: posts big blind $3
*** HOLE CARDS ***
TbIP-TbIP 88: raises $3 to $6
tomasooo29: calls $3
*** FLOP *** [Ah Ts 8h]
tomasooo29: checks
TbIP-TbIP 88: bets $3
tomasooo29: raises $3 to $6
TbIP-TbIP 88: calls $3
*** TURN *** [Ah Ts 8h] [As]
tomasooo29: bets $6
TbIP-TbIP 88: calls $6
*** RIVER *** [Ah Ts 8h As] [5c]
tomasooo29: bets $6
TbIP-TbIP 88: calls $6
*** SHOW DOWN ***
tomasooo29: shows [Qs Th] (two pair, Aces and Tens)
TbIP-TbIP 88: mucks hand
tomasooo29 collected $47.50 from pot
*** SUMMARY ***
Total pot $48 | Rake $0.50
Board [Ah Ts 8h As 5c]
Seat 3: tomasooo29 (big blind) showed [Qs Th] and won ($47.50) with two pair, Aces and Tens
Seat 4: TbIP-TbIP 88 (button) (small blind) mucked


PokerStars Hand #169296072004:  Hold'em Limit ($3/$6 USD) - 2017/04/20 5:07:29 ET
Table 'Titius' 6-max Seat #3 is the button
Seat 3: tomasooo29 ($137.47 in chips)
Seat 4: TbIP-TbIP 88 ($154.66 in chips)
tomasooo29: posts small blind $1
TbIP-TbIP 88: posts big blind $3
*** HOLE CARDS ***
tomasooo29: raises $3 to $6
TbIP-TbIP 88: calls $3
*** FLOP *** [7d 4s Jh]
TbIP-TbIP 88: checks
tomasooo29: bets $3
TbIP-TbIP 88: folds
Uncalled bet ($3) returned to tomasooo29
tomasooo29 collected $11.76 from pot
tomasooo29: doesn't show hand
*** SUMMARY ***
Total pot $12 | Rake $0.24
Board [7d 4s Jh]
Seat 3: tomasooo29 (button) (small blind) collected ($11.76)
Seat 4: TbIP-TbIP 88 (big blind) folded on the Flop


PokerStars Hand #169296082206:  Hold'em Limit ($3/$6 USD) - 2017/04/20 5:07:56 ET
Table 'Titius' 6-max Seat #4 is the button
Seat 3: tomasooo29 ($143.23 in chips)
Seat 4: TbIP-TbIP 88 ($148.66 in chips)
TbIP-TbIP 88: posts small blind $1
tomasooo29: posts big blind $3
*** HOLE CARDS ***
TbIP-TbIP 88: raises $3 to $6
tomasooo29: calls $3
*** FLOP *** [4d 9s 5d]
tomasooo29: checks
TbIP-TbIP 88: bets $3
tomasooo29: folds
Uncalled bet ($3) returned to TbIP-TbIP 88
TbIP-TbIP 88 collected $11.76 from pot
TbIP-TbIP 88: doesn't show hand
*** SUMMARY ***
Total pot $12 | Rake $0.24
Board [4d 9s 5d]
Seat 3: tomasooo29 (big blind) folded on the Flop
Seat 4: TbIP-TbIP 88 (button) (small blind) collected ($11.76)


PokerStars Hand #169296086627:  Hold'em Limit ($3/$6 USD) - 2017/04/20 5:08:07 ET
Table 'Titius' 6-max Seat #3 is the button
Seat 3: tomasooo29 ($137.23 in chips)
Seat 4: TbIP-TbIP 88 ($154.42 in chips)
tomasooo29: posts small blind $1
TbIP-TbIP 88: posts big blind $3
*** HOLE CARDS ***
tomasooo29: raises $3 to $6
TbIP-TbIP 88: calls $3
*** FLOP *** [5c Qs 2s]
TbIP-TbIP 88: checks
tomasooo29: checks
*** TURN *** [5c Qs 2s] [4c]
TbIP-TbIP 88: checks
tomasooo29: bets $6
TbIP-TbIP 88: folds
Uncalled bet ($6) returned to tomasooo29
tomasooo29 collected $11.76 from pot
tomasooo29: doesn't show hand
*** SUMMARY ***
Total pot $12 | Rake $0.24
Board [5c Qs 2s 4c]
Seat 3: tomasooo29 (button) (small blind) collected ($11.76)
Seat 4: TbIP-TbIP 88 (big blind) folded on the Turn


PokerStars Hand #169296103074:  Hold'em Limit ($3/$6 USD) - 2017/04/20 5:08:50 ET
Table 'Titius' 6-max Seat #4 is the button
Seat 3: tomasooo29 ($142.99 in chips)
Seat 4: TbIP-TbIP 88 ($148.42 in chips)
TbIP-TbIP 88: posts small blind $1
tomasooo29: posts big blind $3
*** HOLE CARDS ***
TbIP-TbIP 88: raises $3 to $6
tomasooo29: raises $3 to $9
TbIP-TbIP 88: calls $3
*** FLOP *** [2c Jc Th]
tomasooo29: bets $3
TbIP-TbIP 88: folds
Uncalled bet ($3) returned to tomasooo29
tomasooo29 collected $17.64 from pot
tomasooo29: doesn't show hand
*** SUMMARY ***
Total pot $18 | Rake $0.36
Board [2c Jc Th]
Seat 3: tomasooo29 (big blind) collected ($17.64)
Seat 4: TbIP-TbIP 88 (button) (small blind) folded on the Flop


PokerStars Hand #169296108250:  Hold'em Limit ($3/$6 USD) - 2017/04/20 5:09:03 ET
Table 'Titius' 6-max Seat #3 is the button
Seat 3: tomasooo29 ($151.63 in chips)
Seat 4: TbIP-TbIP 88 ($139.42 in chips)
tomasooo29: posts small blind $1
TbIP-TbIP 88: posts big blind $3
*** HOLE CARDS ***
tomasooo29: raises $3 to $6
TbIP-TbIP 88: calls $3
*** FLOP *** [As 9c Kh]
TbIP-TbIP 88: checks
tomasooo29: checks
*** TURN *** [As 9c Kh] [Qh]
TbIP-TbIP 88: checks
tomasooo29: bets $6
TbIP-TbIP 88: calls $6
*** RIVER *** [As 9c Kh Qh] [6c]
TbIP-TbIP 88: checks
tomasooo29: bets $6
TbIP-TbIP 88: calls $6
*** SHOW DOWN ***
tomasooo29: shows [Kc 5c] (a pair of Kings)
TbIP-TbIP 88: mucks hand
tomasooo29 collected $35.50 from pot
*** SUMMARY ***
Total pot $36 | Rake $0.50
Board [As 9c Kh Qh 6c]
Seat 3: tomasooo29 (button) (small blind) showed [Kc 5c] and won ($35.50) with a pair of Kings
Seat 4: TbIP-TbIP 88 (big blind) mucked


PokerStars Hand #169296116191:  Hold'em Limit ($3/$6 USD) - 2017/04/20 5:09:24 ET
Table 'Titius' 6-max Seat #4 is the button
Seat 3: tomasooo29 ($169.13 in chips)
Seat 4: TbIP-TbIP 88 ($121.42 in chips)
TbIP-TbIP 88: posts small blind $1
tomasooo29: posts big blind $3
*** HOLE CARDS ***
TbIP-TbIP 88: raises $3 to $6
tomasooo29: calls $3
*** FLOP *** [4h Ah Jd]
tomasooo29: checks
TbIP-TbIP 88: bets $3
tomasooo29: calls $3
*** TURN *** [4h Ah Jd] [Jh]
tomasooo29: checks
TbIP-TbIP 88: checks
*** RIVER *** [4h Ah Jd Jh] [3h]
tomasooo29: bets $6
TbIP-TbIP 88: calls $6
*** SHOW DOWN ***
tomasooo29: shows [4c 4d] (a full house, Fours full of Jacks)
TbIP-TbIP 88: mucks hand
tomasooo29 collected $29.50 from pot
*** SUMMARY ***
Total pot $30 | Rake $0.50
Board [4h Ah Jd Jh 3h]
Seat 3: tomasooo29 (big blind) showed [4c 4d] and won ($29.50) with a full house, Fours full of Jacks
Seat 4: TbIP-TbIP 88 (button) (small blind) mucked


PokerStars Hand #169296124455:  Hold'em Limit ($3/$6 USD) - 2017/04/20 5:09:45 ET
Table 'Titius' 6-max Seat #3 is the button
Seat 3: tomasooo29 ($183.63 in chips)
Seat 4: TbIP-TbIP 88 ($106.42 in chips)
tomasooo29: posts small blind $1
TbIP-TbIP 88: posts big blind $3
*** HOLE CARDS ***
tomasooo29: calls $2
TbIP-TbIP 88: checks
*** FLOP *** [7h 4s 2d]
TbIP-TbIP 88: bets $3
tomasooo29: folds
Uncalled bet ($3) returned to TbIP-TbIP 88
TbIP-TbIP 88 collected $5.88 from pot
TbIP-TbIP 88: doesn't show hand
*** SUMMARY ***
Total pot $6 | Rake $0.12
Board [7h 4s 2d]
Seat 3: tomasooo29 (button) (small blind) folded on the Flop
Seat 4: TbIP-TbIP 88 (big blind) collected ($5.88)


PokerStars Hand #169296128682:  Hold'em Limit ($3/$6 USD) - 2017/04/20 5:09:56 ET
Table 'Titius' 6-max Seat #4 is the button
Seat 3: tomasooo29 ($180.63 in chips)
Seat 4: TbIP-TbIP 88 ($109.30 in chips)
TbIP-TbIP 88: posts small blind $1
tomasooo29: posts big blind $3
*** HOLE CARDS ***
TbIP-TbIP 88: raises $3 to $6
tomasooo29: calls $3
*** FLOP *** [8h Td Ks]
tomasooo29: checks
TbIP-TbIP 88: bets $3
tomasooo29: folds
Uncalled bet ($3) returned to TbIP-TbIP 88
TbIP-TbIP 88 collected $11.76 from pot
*** SUMMARY ***
Total pot $12 | Rake $0.24
Board [8h Td Ks]
Seat 3: tomasooo29 (big blind) folded on the Flop
Seat 4: TbIP-TbIP 88 (button) (small blind) collected ($11.76)


PokerStars Hand #169296135323:  Hold'em Limit ($3/$6 USD) - 2017/04/20 5:10:13 ET
Table 'Titius' 6-max Seat #3 is the button
Seat 3: tomasooo29 ($174.63 in chips)
Seat 4: TbIP-TbIP 88 ($115.06 in chips)
tomasooo29: posts small blind $1
TbIP-TbIP 88: posts big blind $3
*** HOLE CARDS ***
tomasooo29: raises $3 to $6
TbIP-TbIP 88: folds
Uncalled bet ($3) returned to tomasooo29
tomasooo29 collected $6 from pot
tomasooo29: doesn't show hand
*** SUMMARY ***
Total pot $6 | Rake $0
Seat 3: tomasooo29 (button) (small blind) collected ($6)
Seat 4: TbIP-TbIP 88 (big blind) folded before Flop


