PokerStars Hand #157413853609:  Hold'em Limit ($3/$6 USD) - 2016/08/17 21:14:48 ET
Table 'Tucana' 6-max Seat #5 is the button
Seat 1: Mind90 ($121.33 in chips)
Seat 5: TinaTurner72 ($99 in chips)
TinaTurner72: posts small blind $1
Mind90: posts big blind $3
*** HOLE CARDS ***
TinaTurner72: raises $3 to $6
Mind90: folds
Uncalled bet ($3) returned to TinaTurner72
TinaTurner72 collected $6 from pot
TinaTurner72: doesn't show hand
*** SUMMARY ***
Total pot $6 | Rake $0
Seat 1: Mind90 (big blind) folded before Flop
Seat 5: TinaTurner72 (button) (small blind) collected ($6)


PokerStars Hand #157413896438:  Hold'em Limit ($3/$6 USD) - 2016/08/17 21:16:37 ET
Table 'Tucana' 6-max Seat #1 is the button
Seat 1: Mind90 ($114.85 in chips)
Seat 5: TinaTurner72 ($104.50 in chips)
Mind90: posts small blind $1
TinaTurner72: posts big blind $3
*** HOLE CARDS ***
Mind90: folds
Uncalled bet ($2) returned to TinaTurner72
TinaTurner72 collected $2 from pot
TinaTurner72: doesn't show hand
*** SUMMARY ***
Total pot $2 | Rake $0
Seat 1: Mind90 (button) (small blind) folded before Flop
Seat 5: TinaTurner72 (big blind) collected ($2)


PokerStars Hand #157413883288:  Hold'em Limit ($3/$6 USD) - 2016/08/17 21:16:03 ET
Table 'Tucana' 6-max Seat #5 is the button
Seat 1: Mind90 ($129.85 in chips)
Seat 5: TinaTurner72 ($90 in chips)
TinaTurner72: posts small blind $1
Mind90: posts big blind $3
*** HOLE CARDS ***
TinaTurner72: raises $3 to $6
Mind90: calls $3
*** FLOP *** [7d 3d 6c]
Mind90: checks
TinaTurner72: bets $3
Mind90: calls $3
*** TURN *** [7d 3d 6c] [5h]
Mind90: checks
TinaTurner72: bets $6
Mind90: calls $6
*** RIVER *** [7d 3d 6c 5h] [8d]
Mind90: checks
TinaTurner72: checks
*** SHOW DOWN ***
Mind90: shows [3s Ac] (a pair of Threes)
TinaTurner72: shows [7s Jh] (a pair of Sevens)
TinaTurner72 collected $29.50 from pot
*** SUMMARY ***
Total pot $30 | Rake $0.50
Board [7d 3d 6c 5h 8d]
Seat 1: Mind90 (big blind) showed [3s Ac] and lost with a pair of Threes
Seat 5: TinaTurner72 (button) (small blind) showed [7s Jh] and won ($29.50) with a pair of Sevens


PokerStars Hand #157413858618:  Hold'em Limit ($3/$6 USD) - 2016/08/17 21:15:00 ET
Table 'Tucana' 6-max Seat #1 is the button
Seat 1: Mind90 ($118.33 in chips)
Seat 5: TinaTurner72 ($102 in chips)
Mind90: posts small blind $1
TinaTurner72: posts big blind $3
*** HOLE CARDS ***
Mind90: raises $3 to $6
TinaTurner72: calls $3
*** FLOP *** [5h 8s 5d]
TinaTurner72: checks
Mind90: bets $3
TinaTurner72: raises $3 to $6
Mind90: calls $3
*** TURN *** [5h 8s 5d] [5s]
TinaTurner72: checks
Mind90: bets $6
TinaTurner72: folds
Uncalled bet ($6) returned to Mind90
Mind90 collected $23.52 from pot
Mind90: doesn't show hand
*** SUMMARY ***
Total pot $24 | Rake $0.48
Board [5h 8s 5d 5s]
Seat 1: Mind90 (button) (small blind) collected ($23.52)
Seat 5: TinaTurner72 (big blind) folded on the Turn


PokerStars Hand #157413908761:  Hold'em Limit ($3/$6 USD) - 2016/08/17 21:17:08 ET
Table 'Tucana' 6-max Seat #1 is the button
Seat 1: Mind90 ($122.49 in chips)
Seat 5: TinaTurner72 ($96.50 in chips)
Mind90: posts small blind $1
TinaTurner72: posts big blind $3
*** HOLE CARDS ***
Mind90: raises $3 to $6
TinaTurner72: folds
Uncalled bet ($3) returned to Mind90
Mind90 collected $6 from pot
Mind90: doesn't show hand
*** SUMMARY ***
Total pot $6 | Rake $0
Seat 1: Mind90 (button) (small blind) collected ($6)
Seat 5: TinaTurner72 (big blind) folded before Flop


PokerStars Hand #157413898398:  Hold'em Limit ($3/$6 USD) - 2016/08/17 21:16:42 ET
Table 'Tucana' 6-max Seat #5 is the button
Seat 1: Mind90 ($113.85 in chips)
Seat 5: TinaTurner72 ($105.50 in chips)
TinaTurner72: posts small blind $1
Mind90: posts big blind $3
*** HOLE CARDS ***
TinaTurner72: raises $3 to $6
Mind90: raises $3 to $9
TinaTurner72: calls $3
*** FLOP *** [3c Qc 7c]
Mind90: bets $3
TinaTurner72: folds
Uncalled bet ($3) returned to Mind90
Mind90 collected $17.64 from pot
Mind90: doesn't show hand
*** SUMMARY ***
Total pot $18 | Rake $0.36
Board [3c Qc 7c]
Seat 1: Mind90 (big blind) collected ($17.64)
Seat 5: TinaTurner72 (button) (small blind) folded on the Flop


PokerStars Hand #157413919172:  Hold'em Limit ($3/$6 USD) - 2016/08/17 21:17:35 ET
Table 'Tucana' 6-max Seat #1 is the button
Seat 1: Mind90 ($131.25 in chips)
Seat 5: TinaTurner72 ($87.50 in chips)
Mind90: posts small blind $1
TinaTurner72: posts big blind $3
*** HOLE CARDS ***
Mind90: raises $3 to $6
TinaTurner72: folds
Uncalled bet ($3) returned to Mind90
Mind90 collected $6 from pot
Mind90: doesn't show hand
*** SUMMARY ***
Total pot $6 | Rake $0
Seat 1: Mind90 (button) (small blind) collected ($6)
Seat 5: TinaTurner72 (big blind) folded before Flop


PokerStars Hand #157413910807:  Hold'em Limit ($3/$6 USD) - 2016/08/17 21:17:14 ET
Table 'Tucana' 6-max Seat #5 is the button
Seat 1: Mind90 ($125.49 in chips)
Seat 5: TinaTurner72 ($93.50 in chips)
TinaTurner72: posts small blind $1
Mind90: posts big blind $3
*** HOLE CARDS ***
TinaTurner72: raises $3 to $6
Mind90: calls $3
*** FLOP *** [Qh 3s Ac]
Mind90: bets $3
TinaTurner72: folds
Uncalled bet ($3) returned to Mind90
Mind90 collected $11.76 from pot
Mind90: doesn't show hand
*** SUMMARY ***
Total pot $12 | Rake $0.24
Board [Qh 3s Ac]
Seat 1: Mind90 (big blind) collected ($11.76)
Seat 5: TinaTurner72 (button) (small blind) folded on the Flop


PokerStars Hand #157414055212:  Hold'em Limit ($3/$6 USD) - 2016/08/17 21:23:28 ET
Table 'Tucana' 6-max Seat #6 is the button
Seat 5: TinaTurner72 ($87.50 in chips)
Seat 6: Mind90 ($111.90 in chips)
Mind90: posts small blind $1
TinaTurner72: posts big blind $3
*** HOLE CARDS ***
Mind90: raises $3 to $6
TinaTurner72: calls $3
*** FLOP *** [4s Jh Qh]
TinaTurner72: checks
Mind90: bets $3
TinaTurner72: calls $3
*** TURN *** [4s Jh Qh] [Td]
TinaTurner72: checks
Mind90: bets $6
TinaTurner72: calls $6
*** RIVER *** [4s Jh Qh Td] [Kd]
TinaTurner72: checks
Mind90: checks
*** SHOW DOWN ***
TinaTurner72: shows [As 2d] (a straight, Ten to Ace)
Mind90: mucks hand
TinaTurner72 collected $29.50 from pot
*** SUMMARY ***
Total pot $30 | Rake $0.50
Board [4s Jh Qh Td Kd]
Seat 5: TinaTurner72 (big blind) showed [As 2d] and won ($29.50) with a straight, Ten to Ace
Seat 6: Mind90 (button) (small blind) mucked


PokerStars Hand #157414071143:  Hold'em Limit ($3/$6 USD) - 2016/08/17 21:24:06 ET
Table 'Tucana' 6-max Seat #5 is the button
Seat 5: TinaTurner72 ($102 in chips)
Seat 6: Mind90 ($96.90 in chips)
TinaTurner72: posts small blind $1
Mind90: posts big blind $3
*** HOLE CARDS ***
TinaTurner72: raises $3 to $6
Mind90: raises $3 to $9
TinaTurner72: calls $3
*** FLOP *** [Kh 9c 2d]
Mind90: bets $3
TinaTurner72: folds
Uncalled bet ($3) returned to Mind90
Mind90 collected $17.64 from pot
Mind90: doesn't show hand
*** SUMMARY ***
Total pot $18 | Rake $0.36
Board [Kh 9c 2d]
Seat 5: TinaTurner72 (button) (small blind) folded on the Flop
Seat 6: Mind90 (big blind) collected ($17.64)


PokerStars Hand #157414077032:  Hold'em Limit ($3/$6 USD) - 2016/08/17 21:24:21 ET
Table 'Tucana' 6-max Seat #6 is the button
Seat 5: TinaTurner72 ($93 in chips)
Seat 6: Mind90 ($105.54 in chips)
Mind90: posts small blind $1
TinaTurner72: posts big blind $3
*** HOLE CARDS ***
Mind90: raises $3 to $6
TinaTurner72: raises $3 to $9
Mind90: calls $3
*** FLOP *** [2h 4s Th]
TinaTurner72: bets $3
Mind90: calls $3
*** TURN *** [2h 4s Th] [4h]
TinaTurner72: bets $6
Mind90: raises $6 to $12
TinaTurner72: calls $6
*** RIVER *** [2h 4s Th 4h] [Ac]
TinaTurner72: checks
Mind90: bets $6
TinaTurner72: calls $6
*** SHOW DOWN ***
Mind90: shows [Qh 6d] (a pair of Fours)
TinaTurner72: shows [9h Kd] (a pair of Fours - Ace+King kicker)
TinaTurner72 collected $59.50 from pot
*** SUMMARY ***
Total pot $60 | Rake $0.50
Board [2h 4s Th 4h Ac]
Seat 5: TinaTurner72 (big blind) showed [9h Kd] and won ($59.50) with a pair of Fours
Seat 6: Mind90 (button) (small blind) showed [Qh 6d] and lost with a pair of Fours


