PokerStars Hand #144834966109:  Hold'em Limit ($3/$6 USD) - 2015/12/04 19:13:23 ET
Table 'Virgo II' 6-max Seat #1 is the button
Seat 1: mdif ($152.88 in chips)
Seat 2: fluit83 ($27 in chips)
mdif: posts small blind $1
fluit83: posts big blind $3
*** HOLE CARDS ***
mdif: raises $3 to $6
bhai187 joins the table at seat #4
fluit83: calls $3
*** FLOP *** [4s Js 5c]
fluit83: checks
mdif: bets $3
fluit83: folds
Uncalled bet ($3) returned to mdif
mdif collected $11.76 from pot
mdif: doesn't show hand
*** SUMMARY ***
Total pot $12 | Rake $0.24
Board [4s Js 5c]
Seat 1: mdif (button) (small blind) collected ($11.76)
Seat 2: fluit83 (big blind) folded on the Flop


PokerStars Hand #144834955321:  Hold'em Limit ($3/$6 USD) - 2015/12/04 19:13:08 ET
Table 'Virgo II' 6-max Seat #2 is the button
Seat 1: mdif ($150 in chips)
Seat 2: fluit83 ($30 in chips)
fluit83: posts small blind $1
SashaYuvelir: is sitting out
mdif: posts big blind $3
*** HOLE CARDS ***
SashaYuvelir leaves the table
SashaYuvelir joins the table at seat #3
fluit83: calls $2
mdif: checks
*** FLOP *** [Ah Qs Th]
mdif: bets $3
fluit83: folds
Uncalled bet ($3) returned to mdif
mdif collected $5.88 from pot
mdif: doesn't show hand
*** SUMMARY ***
Total pot $6 | Rake $0.12
Board [Ah Qs Th]
Seat 1: mdif (big blind) collected ($5.88)
Seat 2: fluit83 (button) (small blind) folded on the Flop


PokerStars Hand #144836509917:  Hold'em Limit ($3/$6 USD) - 2015/12/04 19:52:17 ET
Table 'Virgo II' 6-max Seat #4 is the button
Seat 4: FeiteFrank ($69.64 in chips)
Seat 5: Chessnok ($200.95 in chips)
FeiteFrank: posts small blind $1
Chessnok: posts big blind $3
*** HOLE CARDS ***
mdif leaves the table
FeiteFrank: folds
Uncalled bet ($2) returned to Chessnok
Chessnok collected $2 from pot
Chessnok: doesn't show hand
*** SUMMARY ***
Total pot $2 | Rake $0
Seat 4: FeiteFrank (button) (small blind) folded before Flop
Seat 5: Chessnok (big blind) collected ($2)


PokerStars Hand #144836507298:  Hold'em Limit ($3/$6 USD) - 2015/12/04 19:52:13 ET
Table 'Virgo II' 6-max Seat #5 is the button
Seat 4: FeiteFrank ($68.64 in chips)
Seat 5: Chessnok ($201.95 in chips)
Chessnok: posts small blind $1
mdif: is sitting out
FeiteFrank: posts big blind $3
*** HOLE CARDS ***
Chessnok: folds
Uncalled bet ($2) returned to FeiteFrank
FeiteFrank collected $2 from pot
*** SUMMARY ***
Total pot $2 | Rake $0
Seat 4: FeiteFrank (big blind) collected ($2)
Seat 5: Chessnok (button) (small blind) folded before Flop


